Customer ID,Recency,Frequency,Monetary,R_Score,F_Score,M_Score,RFM_Score,Segment
12346.0,67,15,-64.68,3,5,1,9,🔄 Moyen
12347.0,3,2,1323.32,5,2,4,11,⭐ Fidèle
12348.0,74,1,222.16,2,1,1,4,⚠️ À réactiver
12349.0,43,4,2646.9900000000002,3,3,5,11,⭐ Fidèle
12351.0,11,1,300.93,5,1,2,8,🔄 Moyen
12352.0,11,2,343.8,5,2,2,9,🔄 Moyen
12353.0,44,1,317.76,3,1,2,6,⚠️ À réactiver
12355.0,203,1,488.21,1,1,3,5,⚠️ À réactiver
12356.0,16,3,3562.25,4,3,5,12,⭐ Fidèle
12357.0,24,2,12079.99,4,2,5,11,⭐ Fidèle
12358.0,11,3,2719.01,5,3,5,13,🏆 VIP
12359.0,61,8,2469.36,3,5,5,13,🏆 VIP
12360.0,15,6,1550.83,5,4,4,13,🏆 VIP
12361.0,98,3,321.35,2,3,2,7,🔄 Moyen
12362.0,374,1,130.0,1,1,1,3,⚠️ À réactiver
12366.0,269,1,500.24,1,1,3,5,⚠️ À réactiver
12368.0,264,1,917.7,1,1,3,5,⚠️ À réactiver
12369.0,49,3,1791.1499999999999,3,3,4,10,⭐ Fidèle
12370.0,260,3,774.62,1,3,3,7,🔄 Moyen
12371.0,45,3,2179.42,3,3,5,11,⭐ Fidèle
12373.0,260,2,763.05,1,2,3,6,⚠️ À réactiver
12374.0,57,3,2246.29,3,3,5,11,⭐ Fidèle
12376.0,25,2,503.15,4,2,3,9,🔄 Moyen
12377.0,17,2,1798.2,4,2,4,10,⭐ Fidèle
12378.0,198,1,1407.7,1,1,4,6,⚠️ À réactiver
12379.0,58,2,767.98,3,2,3,8,🔄 Moyen
12380.0,17,10,5167.44,4,5,5,14,🏆 VIP
12382.0,318,1,-18.38,1,1,1,3,⚠️ À réactiver
12385.0,15,2,1923.4,5,2,4,11,⭐ Fidèle
12386.0,2,1,258.90000000000003,5,1,2,8,🔄 Moyen
12387.0,51,1,143.94,3,1,1,5,⚠️ À réactiver
12388.0,81,2,1120.45,2,2,4,8,🔄 Moyen
12389.0,38,3,1433.33,3,3,4,10,⭐ Fidèle
12391.0,100,6,2286.93,2,4,5,11,⭐ Fidèle
12392.0,227,1,234.75,1,1,2,4,⚠️ À réactiver
12393.0,18,3,794.15,4,3,3,10,⭐ Fidèle
12395.0,7,4,2048.64,5,3,4,12,⭐ Fidèle
12396.0,310,1,931.43,1,1,3,5,⚠️ À réactiver
12399.0,21,3,853.65,4,3,3,10,⭐ Fidèle
12400.0,50,1,205.25,3,1,1,5,⚠️ À réactiver
12402.0,28,6,1018.55,4,4,4,12,⭐ Fidèle
12403.0,157,1,591.6600000000001,2,1,3,6,⚠️ À réactiver
12404.0,318,1,63.24,1,1,1,3,⚠️ À réactiver
12406.0,24,4,2791.46,4,3,5,12,⭐ Fidèle
12408.0,15,5,1437.07,5,4,4,13,🏆 VIP
12409.0,56,6,12033.54,3,4,5,12,⭐ Fidèle
12410.0,138,1,320.38,2,1,2,5,⚠️ À réactiver
12411.0,45,1,346.9,3,1,2,6,⚠️ À réactiver
12412.0,38,5,1354.15,3,4,4,11,⭐ Fidèle
12413.0,38,1,241.35,3,1,2,6,⚠️ À réactiver
12414.0,99,5,130.0,2,4,1,7,🔄 Moyen
12415.0,11,7,19543.84,5,4,5,14,🏆 VIP
12416.0,292,1,202.56,1,1,1,3,⚠️ À réactiver
12417.0,37,15,3129.41,3,5,5,13,🏆 VIP
12418.0,49,4,1348.37,3,3,4,10,⭐ Fidèle
12419.0,21,2,503.01,4,2,3,9,🔄 Moyen
12421.0,51,3,286.56,3,3,2,8,🔄 Moyen
12422.0,30,18,3315.79,4,5,5,14,🏆 VIP
12423.0,23,2,763.08,4,2,3,9,🔄 Moyen
12424.0,58,5,1528.82,3,4,4,11,⭐ Fidèle
12425.0,66,2,903.61,3,2,3,8,🔄 Moyen
12426.0,282,2,728.68,1,2,3,6,⚠️ À réactiver
12427.0,7,1,303.5,5,1,2,8,🔄 Moyen
12429.0,1,6,3685.11,5,4,5,14,🏆 VIP
12431.0,9,16,4303.02,5,5,5,15,🏆 VIP
12433.0,2,6,7052.99,5,4,5,14,🏆 VIP
12434.0,17,1,297.29,4,1,2,7,🔄 Moyen
12435.0,32,4,6096.04,4,3,5,12,⭐ Fidèle
12437.0,29,28,7498.19,4,5,5,14,🏆 VIP
12439.0,318,3,1104.48,1,3,4,8,🔄 Moyen
12440.0,93,3,768.15,2,3,3,8,🔄 Moyen
12441.0,2,1,173.55,5,1,1,7,🔄 Moyen
12443.0,368,1,485.31,1,1,3,5,⚠️ À réactiver
12445.0,36,2,293.08,3,2,2,7,🔄 Moyen
12449.0,46,2,768.6,3,2,3,8,🔄 Moyen
12450.0,35,5,469.07,4,4,2,10,⭐ Fidèle
12451.0,99,4,3613.0099999999998,2,3,5,10,⭐ Fidèle
12454.0,31,7,4292.71,4,4,5,13,🏆 VIP
12455.0,81,4,3413.09,2,3,5,10,⭐ Fidèle
12457.0,53,2,554.53,3,2,3,8,🔄 Moyen
12458.0,63,2,830.09,3,2,3,8,🔄 Moyen
12459.0,241,1,454.36,1,1,2,4,⚠️ À réactiver
12460.0,92,1,326.65,2,1,2,5,⚠️ À réactiver
12466.0,318,1,56.73,1,1,1,3,⚠️ À réactiver
12467.0,22,2,0.0,4,2,1,7,🔄 Moyen
12468.0,66,7,2900.5099999999998,3,4,5,12,⭐ Fidèle
12469.0,158,2,3070.54,2,2,5,9,🔄 Moyen
12470.0,325,1,211.95,1,1,1,3,⚠️ À réactiver
12471.0,8,81,19207.69,5,5,5,15,🏆 VIP
12472.0,5,26,10727.21,5,5,5,15,🏆 VIP
12474.0,4,25,4849.98,5,5,5,15,🏆 VIP
12475.0,45,1,426.26,3,1,2,6,⚠️ À réactiver
12476.0,10,18,7169.04,5,5,5,15,🏆 VIP
12477.0,35,3,7056.63,4,3,5,12,⭐ Fidèle
12480.0,35,4,2153.47,4,3,5,12,⭐ Fidèle
12481.0,1,8,6626.17,5,5,5,15,🏆 VIP
12482.0,85,32,21893.53,2,5,5,12,⭐ Fidèle
12483.0,14,14,2519.74,5,5,5,15,🏆 VIP
12484.0,113,8,1808.58,2,5,4,11,⭐ Fidèle
12485.0,165,1,708.1,2,1,3,6,⚠️ À réactiver
12486.0,67,1,1037.28,3,1,4,8,🔄 Moyen
12487.0,366,2,259.8,1,2,2,5,⚠️ À réactiver
12490.0,14,12,4400.71,5,5,5,15,🏆 VIP
12492.0,39,1,452.0,3,1,2,6,⚠️ À réactiver
12494.0,1,5,604.17,5,4,3,12,⭐ Fidèle
12495.0,270,2,323.4,1,2,2,5,⚠️ À réactiver
12496.0,256,2,54.09,1,2,1,4,⚠️ À réactiver
12497.0,36,3,5168.65,3,3,5,11,⭐ Fidèle
12499.0,196,1,393.72,1,1,2,4,⚠️ À réactiver
12500.0,71,12,1666.04,2,5,4,11,⭐ Fidèle
12503.0,220,1,1126.0,1,1,4,6,⚠️ À réactiver
12504.0,53,2,297.0,3,2,2,7,🔄 Moyen
12505.0,29,2,912.5,4,2,3,9,🔄 Moyen
12507.0,220,1,539.25,1,1,3,5,⚠️ À réactiver
12510.0,95,14,2706.76,2,5,5,12,⭐ Fidèle
12511.0,50,2,3065.77,3,2,5,10,⭐ Fidèle
12514.0,277,1,580.08,1,1,3,5,⚠️ À réactiver
12516.0,66,2,1336.56,3,2,4,9,🔄 Moyen
12519.0,100,2,354.35,2,2,2,6,⚠️ À réactiver
12523.0,10,17,2475.2799999999997,5,5,5,15,🏆 VIP
12524.0,24,10,6605.64,4,5,5,14,🏆 VIP
12525.0,127,8,835.18,2,5,3,10,⭐ Fidèle
12527.0,130,2,386.8,2,2,2,6,⚠️ À réactiver
12529.0,158,2,311.78,2,2,2,6,⚠️ À réactiver
12530.0,45,7,2066.23,3,4,5,12,⭐ Fidèle
12531.0,316,2,1773.83,1,2,4,7,🔄 Moyen
12533.0,254,6,1149.99,1,4,4,9,🔄 Moyen
12537.0,44,1,732.9399999999999,3,1,3,7,🔄 Moyen
12538.0,14,1,276.5,5,1,2,8,🔄 Moyen
12539.0,86,3,5646.4,2,3,5,10,⭐ Fidèle
12540.0,14,17,8798.25,5,5,5,15,🏆 VIP
12542.0,120,4,423.38,2,3,2,7,🔄 Moyen
12543.0,84,1,980.25,2,1,4,7,🔄 Moyen
12547.0,136,1,175.78,2,1,1,4,⚠️ À réactiver
12549.0,211,6,1575.6799999999998,1,4,4,9,🔄 Moyen
12553.0,21,3,896.5699999999999,4,3,3,10,⭐ Fidèle
12554.0,84,1,468.5,2,1,2,5,⚠️ À réactiver
12555.0,318,1,129.23,1,1,1,3,⚠️ À réactiver
12557.0,7,4,6725.18,5,3,5,13,🏆 VIP
12562.0,21,2,1185.18,4,2,4,10,⭐ Fidèle
12563.0,44,1,249.24,3,1,2,6,⚠️ À réactiver
12567.0,3,8,4278.88,5,5,5,15,🏆 VIP
12568.0,280,1,70.0,1,1,1,3,⚠️ À réactiver
12570.0,318,1,77.52,1,1,1,3,⚠️ À réactiver
12573.0,17,4,556.87,4,3,3,10,⭐ Fidèle
12575.0,93,2,622.82,2,2,3,7,🔄 Moyen
12576.0,28,5,776.89,4,4,3,11,⭐ Fidèle
12577.0,17,5,995.9499999999999,4,4,4,12,⭐ Fidèle
12578.0,21,3,1819.09,4,3,4,11,⭐ Fidèle
12580.0,212,1,637.2,1,1,3,5,⚠️ À réactiver
12582.0,58,2,1469.04,3,2,4,9,🔄 Moyen
12583.0,9,14,7157.5599999999995,5,5,5,15,🏆 VIP
12586.0,4,4,1848.73,5,3,4,12,⭐ Fidèle
12588.0,35,4,724.0799999999999,4,3,3,10,⭐ Fidèle
12589.0,50,9,2447.49,3,5,5,13,🏆 VIP
12590.0,137,2,-7.9,2,2,1,5,⚠️ À réactiver
12591.0,26,2,899.3,4,2,3,9,🔄 Moyen
12592.0,155,6,715.02,2,4,3,9,🔄 Moyen
12594.0,14,6,1724.29,5,4,4,13,🏆 VIP
12595.0,140,1,299.02,2,1,2,5,⚠️ À réactiver
12598.0,71,6,1411.99,2,4,4,10,⭐ Fidèle
12599.0,17,6,1264.14,4,4,4,12,⭐ Fidèle
12600.0,7,16,2374.75,5,5,5,15,🏆 VIP
12601.0,40,1,104.2,3,1,1,5,⚠️ À réactiver
12605.0,1,5,1225.45,5,4,4,13,🏆 VIP
12606.0,318,1,21.0,1,1,1,3,⚠️ À réactiver
12608.0,40,1,415.79,3,1,2,6,⚠️ À réactiver
12609.0,10,7,2291.0099999999998,5,4,5,14,🏆 VIP
12613.0,24,7,3372.54,4,4,5,13,🏆 VIP
12615.0,49,7,3273.69,3,4,5,12,⭐ Fidèle
12616.0,18,2,388.09999999999997,4,2,2,8,🔄 Moyen
12619.0,196,1,140.14,1,1,1,3,⚠️ À réactiver
12621.0,1,22,10967.24,5,5,5,15,🏆 VIP
12623.0,52,8,3334.74,3,5,5,13,🏆 VIP
12625.0,145,2,2481.06,2,2,5,9,🔄 Moyen
12629.0,21,2,1558.22,4,2,4,10,⭐ Fidèle
12631.0,67,6,2811.77,3,4,5,12,⭐ Fidèle
12632.0,156,4,738.88,2,3,3,8,🔄 Moyen
12633.0,18,5,3454.58,4,4,5,13,🏆 VIP
12634.0,171,2,490.0,2,2,3,7,🔄 Moyen
12635.0,28,2,1241.23,4,2,4,10,⭐ Fidèle
12636.0,374,1,141.0,1,1,1,3,⚠️ À réactiver
12637.0,14,4,2318.41,5,3,5,13,🏆 VIP
12638.0,275,1,249.8,1,1,2,4,⚠️ À réactiver
12639.0,70,2,826.27,3,2,3,8,🔄 Moyen
12643.0,21,8,4536.26,4,5,5,14,🏆 VIP
12644.0,66,5,1337.6299999999999,3,4,4,11,⭐ Fidèle
12645.0,45,5,1743.72,3,4,4,11,⭐ Fidèle
12647.0,3,35,14012.87,5,5,5,15,🏆 VIP
12648.0,70,4,778.95,3,3,3,9,🔄 Moyen
12649.0,1,7,1634.99,5,4,4,13,🏆 VIP
12651.0,14,4,251.3,5,3,2,10,⭐ Fidèle
12652.0,70,1,97.05,3,1,1,5,⚠️ À réactiver
12653.0,162,1,1950.98,2,1,4,7,🔄 Moyen
12655.0,59,1,261.35,3,1,2,6,⚠️ À réactiver
12656.0,61,4,2338.06,3,3,5,11,⭐ Fidèle
12661.0,72,1,162.0,2,1,1,4,⚠️ À réactiver
12662.0,9,11,3132.09,5,5,5,15,🏆 VIP
12663.0,260,3,204.0,1,3,1,5,⚠️ À réactiver
12664.0,150,2,1188.16,2,2,4,8,🔄 Moyen
12665.0,53,3,239.7,3,3,2,8,🔄 Moyen
12666.0,30,1,1248.42,4,1,4,9,🔄 Moyen
12668.0,14,6,7637.53,5,4,5,14,🏆 VIP
12670.0,21,2,764.24,4,2,3,9,🔄 Moyen
12671.0,242,1,2622.48,1,1,5,7,🔄 Moyen
12672.0,225,2,184.6,1,2,1,4,⚠️ À réactiver
12673.0,37,1,619.5,3,1,3,7,🔄 Moyen
12675.0,189,4,934.8,1,3,3,7,🔄 Moyen
12676.0,44,6,1441.7,3,4,4,11,⭐ Fidèle
12677.0,191,3,389.3,1,3,2,6,⚠️ À réactiver
12678.0,11,10,16262.87,5,5,5,15,🏆 VIP
12681.0,3,30,16874.17,5,5,5,15,🏆 VIP
12682.0,1,24,11657.59,5,5,5,15,🏆 VIP
12683.0,1,9,4197.51,5,5,5,15,🏆 VIP
12686.0,7,1,89.14,5,1,1,7,🔄 Moyen
12687.0,116,2,2138.91,2,2,5,9,🔄 Moyen
12691.0,56,1,134.6,3,1,1,5,⚠️ À réactiver
12692.0,273,1,110.95,1,1,1,3,⚠️ À réactiver
12693.0,32,5,809.46,4,4,3,11,⭐ Fidèle
12694.0,51,2,969.78,3,2,4,9,🔄 Moyen
12695.0,164,3,825.02,2,3,3,8,🔄 Moyen
12696.0,70,3,801.15,3,3,3,9,🔄 Moyen
12698.0,226,1,339.75,1,1,2,4,⚠️ À réactiver
12699.0,53,1,638.11,3,1,3,7,🔄 Moyen
12701.0,165,4,1648.7,2,3,4,9,🔄 Moyen
12703.0,269,5,617.48,1,4,3,8,🔄 Moyen
12705.0,10,8,4739.76,5,5,5,15,🏆 VIP
12706.0,318,1,-91.89,1,1,1,3,⚠️ À réactiver
12708.0,4,15,2501.84,5,5,5,15,🏆 VIP
12709.0,2,30,21018.51,5,5,5,15,🏆 VIP
12711.0,247,2,1339.05,1,2,4,7,🔄 Moyen
12712.0,1,14,2738.03,5,5,5,15,🏆 VIP
12714.0,24,7,9384.85,4,4,5,13,🏆 VIP
12717.0,226,1,277.93,1,1,2,4,⚠️ À réactiver
12720.0,5,13,2334.6,5,5,5,15,🏆 VIP
12721.0,1,4,1277.7,5,3,4,12,⭐ Fidèle
12724.0,19,3,1286.11,4,3,4,11,⭐ Fidèle
12725.0,7,4,2266.7599999999998,5,3,5,13,🏆 VIP
12726.0,23,4,1405.5,4,3,4,11,⭐ Fidèle
12727.0,78,3,1698.83,2,3,4,9,🔄 Moyen
12728.0,19,1,233.84,4,1,2,7,🔄 Moyen
12730.0,157,1,829.25,2,1,3,6,⚠️ À réactiver
12731.0,78,5,6879.8,2,4,5,11,⭐ Fidèle
12733.0,25,5,1942.8700000000001,4,4,4,12,⭐ Fidèle
12734.0,10,2,529.25,5,2,3,10,⭐ Fidèle
12737.0,134,2,3710.5,2,2,5,9,🔄 Moyen
12738.0,8,1,155.35,5,1,1,7,🔄 Moyen
12739.0,21,2,1713.69,4,2,4,10,⭐ Fidèle
12741.0,165,2,406.07,2,2,2,6,⚠️ À réactiver
12742.0,235,2,1185.02,1,2,4,7,🔄 Moyen
12744.0,95,4,4037.77,2,3,5,10,⭐ Fidèle
12745.0,122,3,925.41,2,3,3,8,🔄 Moyen
12746.0,163,3,230.85,2,3,2,7,🔄 Moyen
12747.0,5,22,4968.58,5,5,5,15,🏆 VIP
12748.0,1,159,20898.03,5,5,5,15,🏆 VIP
12749.0,21,8,2460.29,4,5,5,14,🏆 VIP
12751.0,80,1,268.27,2,1,2,5,⚠️ À réactiver
12755.0,1,19,4203.15,5,5,5,15,🏆 VIP
12758.0,95,6,6987.41,2,4,5,11,⭐ Fidèle
12759.0,22,5,3489.2999999999997,4,4,5,13,🏆 VIP
12760.0,91,1,347.8,2,1,2,5,⚠️ À réactiver
12761.0,93,2,782.95,2,2,3,7,🔄 Moyen
12763.0,5,1,320.08,5,1,2,8,🔄 Moyen
12765.0,108,6,1404.58,2,4,4,10,⭐ Fidèle
12766.0,2,5,3036.8,5,4,5,14,🏆 VIP
12767.0,11,1,949.8199999999999,5,1,4,10,⭐ Fidèle
12768.0,67,2,-3.552713678800501e-15,3,2,1,6,⚠️ À réactiver
12770.0,35,6,1624.5,4,4,4,12,⭐ Fidèle
12771.0,100,2,262.5,2,2,2,6,⚠️ À réactiver
12773.0,200,2,0.0,1,2,1,4,⚠️ À réactiver
12774.0,171,1,98.7,2,1,1,4,⚠️ À réactiver
12775.0,24,2,300.08,4,2,2,8,🔄 Moyen
12776.0,303,1,55.5,1,1,1,3,⚠️ À réactiver
12777.0,93,1,519.45,2,1,3,6,⚠️ À réactiver
12778.0,32,3,953.4499999999999,4,3,4,11,⭐ Fidèle
12779.0,7,10,2538.06,5,5,5,15,🏆 VIP
12780.0,234,1,337.4,1,1,2,4,⚠️ À réactiver
12782.0,10,8,2252.72,5,5,5,15,🏆 VIP
12784.0,165,1,1230.33,2,1,4,7,🔄 Moyen
12785.0,171,3,773.6,2,3,3,8,🔄 Moyen
12786.0,245,1,728.5,1,1,3,5,⚠️ À réactiver
12787.0,49,2,395.52,3,2,2,7,🔄 Moyen
12788.0,99,4,444.9,2,3,2,7,🔄 Moyen
12789.0,148,2,181.5,2,2,1,5,⚠️ À réactiver
12790.0,43,2,238.53,3,2,2,7,🔄 Moyen
12791.0,9,8,585.15,5,5,3,13,🏆 VIP
12792.0,170,2,413.34,2,2,2,6,⚠️ À réactiver
12793.0,7,2,471.85,5,2,3,10,⭐ Fidèle
12796.0,264,1,381.0,1,1,2,4,⚠️ À réactiver
12797.0,1,4,531.28,5,3,3,11,⭐ Fidèle
12798.0,57,1,1533.89,3,1,4,8,🔄 Moyen
12799.0,165,1,219.35,2,1,1,4,⚠️ À réactiver
12800.0,106,3,584.25,2,3,3,8,🔄 Moyen
12801.0,113,2,1031.87,2,2,4,8,🔄 Moyen
12802.0,78,7,1937.84,2,4,4,10,⭐ Fidèle
12803.0,29,1,1092.81,4,1,4,9,🔄 Moyen
12804.0,101,2,327.02,2,2,2,6,⚠️ À réactiver
12805.0,17,4,1434.95,4,3,4,11,⭐ Fidèle
12806.0,71,4,2878.96,2,3,5,10,⭐ Fidèle
12807.0,18,3,269.95,4,3,2,9,🔄 Moyen
12808.0,4,3,422.45,5,3,2,10,⭐ Fidèle
12809.0,189,6,1220.98,1,4,4,9,🔄 Moyen
12810.0,170,2,534.99,2,2,3,7,🔄 Moyen
12811.0,14,2,519.05,5,2,3,10,⭐ Fidèle
12813.0,137,3,1687.8,2,3,4,9,🔄 Moyen
12817.0,35,2,524.94,4,2,3,9,🔄 Moyen
12819.0,94,1,540.52,2,1,3,6,⚠️ À réactiver
12820.0,33,9,1705.6,4,5,4,13,🏆 VIP
12821.0,247,1,128.07999999999998,1,1,1,3,⚠️ À réactiver
12823.0,30,13,4742.0,4,5,5,14,🏆 VIP
12825.0,157,2,518.63,2,2,3,7,🔄 Moyen
12826.0,1,8,1460.57,5,5,4,14,🏆 VIP
12829.0,186,1,92.3,1,1,1,3,⚠️ À réactiver
12831.0,99,2,236.06,2,2,2,6,⚠️ À réactiver
12835.0,54,49,6018.67,3,5,5,13,🏆 VIP
12836.0,25,13,3933.61,4,5,5,14,🏆 VIP
12837.0,205,1,554.31,1,1,3,5,⚠️ À réactiver
12838.0,9,11,2692.9,5,5,5,15,🏆 VIP
12839.0,3,16,4344.21,5,5,5,15,🏆 VIP
12840.0,73,5,1299.6,2,4,4,10,⭐ Fidèle
12841.0,5,18,3514.08,5,5,5,15,🏆 VIP
12842.0,40,2,799.0,3,2,3,8,🔄 Moyen
12843.0,18,25,4664.85,4,5,5,14,🏆 VIP
12844.0,78,2,322.64,2,2,2,6,⚠️ À réactiver
12846.0,318,1,15.58,1,1,1,3,⚠️ À réactiver
12847.0,23,1,765.36,4,1,3,8,🔄 Moyen
12848.0,311,1,208.0,1,1,1,3,⚠️ À réactiver
12849.0,17,4,2039.67,4,3,4,11,⭐ Fidèle
12850.0,81,1,330.0,2,1,2,5,⚠️ À réactiver
12851.0,113,1,148.95,2,1,1,4,⚠️ À réactiver
12853.0,57,7,1846.8,3,4,4,11,⭐ Fidèle
12854.0,197,6,1633.22,1,4,4,9,🔄 Moyen
12855.0,8,4,612.84,5,3,3,11,⭐ Fidèle
12857.0,72,5,2577.85,2,4,5,11,⭐ Fidèle
12858.0,19,2,151.73,4,2,1,7,🔄 Moyen
12859.0,94,1,575.1,2,1,3,6,⚠️ À réactiver
12860.0,329,1,55.47,1,1,1,3,⚠️ À réactiver
12861.0,255,1,68.25,1,1,1,3,⚠️ À réactiver
12862.0,61,2,1008.3199999999999,3,2,4,9,🔄 Moyen
12863.0,15,5,2271.35,5,4,5,14,🏆 VIP
12864.0,144,1,152.45,2,1,1,4,⚠️ À réactiver
12865.0,14,2,1755.24,5,2,4,11,⭐ Fidèle
12866.0,110,2,668.23,2,2,3,7,🔄 Moyen
12867.0,33,6,3876.47,4,4,5,13,🏆 VIP
12868.0,9,3,640.0,5,3,3,11,⭐ Fidèle
12869.0,317,1,337.66999999999996,1,1,2,4,⚠️ À réactiver
12870.0,2,4,1662.05,5,3,4,12,⭐ Fidèle
12871.0,75,1,363.38,2,1,2,5,⚠️ À réactiver
12872.0,1,12,3078.37,5,5,5,15,🏆 VIP
12873.0,33,2,1653.3,4,2,4,10,⭐ Fidèle
12874.0,21,3,933.42,4,3,3,10,⭐ Fidèle
12875.0,107,3,1013.76,2,3,4,9,🔄 Moyen
12876.0,30,3,1850.57,4,3,4,11,⭐ Fidèle
12877.0,37,8,1419.4,3,5,4,12,⭐ Fidèle
12880.0,17,2,640.13,4,2,3,9,🔄 Moyen
12887.0,19,1,222.4,4,1,1,6,⚠️ À réactiver
12889.0,17,6,365.65999999999997,4,4,2,10,⭐ Fidèle
12890.0,23,1,336.8,4,1,2,7,🔄 Moyen
12891.0,94,9,488.5,2,5,3,10,⭐ Fidèle
12892.0,32,1,263.38,4,1,2,7,🔄 Moyen
12894.0,211,1,157.35,1,1,1,3,⚠️ À réactiver
12896.0,366,1,-29.75,1,1,1,3,⚠️ À réactiver
12897.0,17,2,297.75,4,2,2,8,🔄 Moyen
12898.0,99,2,310.96,2,2,2,6,⚠️ À réactiver
12899.0,49,1,366.4,3,1,2,6,⚠️ À réactiver
12900.0,58,1,340.33,3,1,2,6,⚠️ À réactiver
12903.0,64,1,833.53,3,1,3,7,🔄 Moyen
12905.0,212,3,1011.8199999999999,1,3,4,8,🔄 Moyen
12907.0,31,3,440.36,4,3,2,9,🔄 Moyen
12908.0,16,3,1026.0,4,3,4,11,⭐ Fidèle
12909.0,58,5,905.9399999999999,3,4,3,10,⭐ Fidèle
12910.0,15,6,2671.98,5,4,5,14,🏆 VIP
12911.0,187,1,1680.47,1,1,4,6,⚠️ À réactiver
12913.0,4,9,4217.23,5,5,5,15,🏆 VIP
12914.0,36,1,223.98,3,1,1,5,⚠️ À réactiver
12915.0,8,7,721.1999999999999,5,4,3,12,⭐ Fidèle
12916.0,78,3,1647.87,2,3,4,9,🔄 Moyen
12917.0,36,7,3735.5,3,4,5,12,⭐ Fidèle
12918.0,262,3,-10953.5,1,3,1,5,⚠️ À réactiver
12920.0,207,3,323.86,1,3,2,6,⚠️ À réactiver
12921.0,2,55,18249.71,5,5,5,15,🏆 VIP
12923.0,26,2,612.9,4,2,3,9,🔄 Moyen
12924.0,28,9,1493.2,4,5,4,13,🏆 VIP
12925.0,228,1,35.28,1,1,1,3,⚠️ À réactiver
12926.0,47,4,1548.46,3,3,4,10,⭐ Fidèle
12927.0,30,1,197.31,4,1,1,6,⚠️ À réactiver
12928.0,14,7,2242.19,5,4,5,14,🏆 VIP
12931.0,16,51,37836.86,4,5,5,14,🏆 VIP
12932.0,175,8,1698.56,2,5,4,11,⭐ Fidèle
12933.0,16,7,1021.0,4,4,4,12,⭐ Fidèle
12934.0,372,1,181.65,1,1,1,3,⚠️ À réactiver
12935.0,10,11,2025.56,5,5,4,14,🏆 VIP
12937.0,99,5,1593.34,2,4,4,10,⭐ Fidèle
12939.0,15,12,13683.0,5,5,5,15,🏆 VIP
12941.0,360,1,377.49,1,1,2,4,⚠️ À réactiver
12942.0,1,1,258.75,5,1,2,8,🔄 Moyen
12943.0,29,3,492.75,4,3,3,10,⭐ Fidèle
12945.0,292,1,437.16,1,1,2,4,⚠️ À réactiver
12946.0,72,1,324.45,2,1,2,5,⚠️ À réactiver
12947.0,9,1,304.03999999999996,5,1,2,8,🔄 Moyen
12948.0,366,2,252.48,1,2,2,5,⚠️ À réactiver
12949.0,18,18,11247.98,4,5,5,14,🏆 VIP
12951.0,10,12,2122.35,5,5,5,15,🏆 VIP
12953.0,158,1,498.96,2,1,3,6,⚠️ À réactiver
12954.0,274,1,162.45,1,1,1,3,⚠️ À réactiver
12956.0,320,3,413.82,1,3,2,6,⚠️ À réactiver
12957.0,177,9,4649.38,2,5,5,12,⭐ Fidèle
12958.0,36,2,539.49,3,2,3,8,🔄 Moyen
12959.0,120,2,133.35,2,2,1,5,⚠️ À réactiver
12960.0,49,4,1322.07,3,3,4,10,⭐ Fidèle
12961.0,15,1,211.99,5,1,1,7,🔄 Moyen
12963.0,1,6,1671.76,5,4,4,13,🏆 VIP
12964.0,73,1,132.24,2,1,1,4,⚠️ À réactiver
12967.0,7,2,2646.02,5,2,5,12,⭐ Fidèle
12969.0,238,1,122.45,1,1,1,3,⚠️ À réactiver
12970.0,16,6,1072.73,4,4,4,12,⭐ Fidèle
12971.0,2,34,4552.48,5,5,5,15,🏆 VIP
12972.0,49,6,1115.95,3,4,4,11,⭐ Fidèle
12973.0,49,1,385.55,3,1,2,6,⚠️ À réactiver
12974.0,201,1,264.15,1,1,2,4,⚠️ À réactiver
12975.0,66,8,1993.99,3,5,4,12,⭐ Fidèle
12976.0,14,7,2417.7799999999997,5,4,5,14,🏆 VIP
12977.0,137,3,478.39,2,3,3,8,🔄 Moyen
12978.0,21,6,2496.07,4,4,5,13,🏆 VIP
12979.0,365,2,479.54,1,2,3,6,⚠️ À réactiver
12980.0,15,14,8817.33,5,5,5,15,🏆 VIP
12982.0,24,15,2184.92,4,5,5,14,🏆 VIP
12983.0,234,1,490.08,1,1,3,5,⚠️ À réactiver
12986.0,38,12,1991.59,3,5,4,12,⭐ Fidèle
12987.0,56,3,753.51,3,3,3,9,🔄 Moyen
12989.0,60,20,5992.29,3,5,5,13,🏆 VIP
12990.0,53,4,546.0,3,3,3,9,🔄 Moyen
12991.0,25,1,261.06,4,1,2,7,🔄 Moyen
12992.0,361,1,93.35,1,1,1,3,⚠️ À réactiver
12993.0,59,6,776.5,3,4,3,10,⭐ Fidèle
12996.0,11,1,355.5,5,1,2,8,🔄 Moyen
12997.0,24,9,867.17,4,5,3,12,⭐ Fidèle
12998.0,128,4,897.38,2,3,3,8,🔄 Moyen
13000.0,206,2,430.15,1,2,2,5,⚠️ À réactiver
13001.0,40,22,14338.13,3,5,5,13,🏆 VIP
13002.0,52,2,293.18,3,2,2,7,🔄 Moyen
13004.0,22,24,5530.5599999999995,4,5,5,14,🏆 VIP
13005.0,63,3,466.08,3,3,2,8,🔄 Moyen
13007.0,215,1,175.25,1,1,1,3,⚠️ À réactiver
13008.0,33,5,364.81,4,4,2,10,⭐ Fidèle
13009.0,308,1,234.0,1,1,2,4,⚠️ À réactiver
13010.0,10,2,330.12,5,2,2,9,🔄 Moyen
13011.0,8,1,50.55,5,1,1,7,🔄 Moyen
13012.0,65,4,1279.56,3,3,4,10,⭐ Fidèle
13013.0,7,18,7814.83,5,5,5,15,🏆 VIP
13014.0,63,2,1855.3999999999999,3,2,4,9,🔄 Moyen
13015.0,64,9,3119.44,3,5,5,13,🏆 VIP
13018.0,37,8,2470.06,3,5,5,13,🏆 VIP
13019.0,15,8,1212.95,5,5,4,14,🏆 VIP
13020.0,184,5,606.96,1,4,3,8,🔄 Moyen
13021.0,1,13,2201.98,5,5,5,15,🏆 VIP
13022.0,65,1,65.3,3,1,1,5,⚠️ À réactiver
13023.0,164,1,759.13,2,1,3,6,⚠️ À réactiver
13024.0,100,3,535.42,2,3,3,8,🔄 Moyen
13025.0,367,1,323.39,1,1,2,4,⚠️ À réactiver
13026.0,124,5,753.97,2,4,3,9,🔄 Moyen
13027.0,21,17,10236.0,4,5,5,14,🏆 VIP
13029.0,10,2,679.8,5,2,3,10,⭐ Fidèle
13030.0,4,1,427.74,5,1,2,8,🔄 Moyen
13031.0,43,5,3419.27,3,4,5,12,⭐ Fidèle
13032.0,28,8,1821.07,4,5,4,13,🏆 VIP
13033.0,65,1,30.0,3,1,1,5,⚠️ À réactiver
13034.0,5,2,279.90999999999997,5,2,2,9,🔄 Moyen
13035.0,67,1,442.32,3,1,2,6,⚠️ À réactiver
13036.0,320,1,307.1,1,1,2,4,⚠️ À réactiver
13037.0,35,13,2961.48,4,5,5,14,🏆 VIP
13039.0,220,4,1010.73,1,3,4,8,🔄 Moyen
13041.0,86,4,799.13,2,3,3,8,🔄 Moyen
13042.0,220,4,1522.79,1,3,4,8,🔄 Moyen
13044.0,128,12,4263.73,2,5,5,12,⭐ Fidèle
13045.0,37,2,503.64,3,2,3,8,🔄 Moyen
13046.0,92,1,319.94,2,1,2,5,⚠️ À réactiver
13047.0,9,27,5387.62,5,5,5,15,🏆 VIP
13048.0,72,8,2229.25,2,5,5,12,⭐ Fidèle
13049.0,25,3,727.46,4,3,3,10,⭐ Fidèle
13050.0,2,30,6137.83,5,5,5,15,🏆 VIP
13051.0,214,2,155.8,1,2,1,4,⚠️ À réactiver
13052.0,56,6,2820.38,3,4,5,12,⭐ Fidèle
13053.0,257,1,127.65,1,1,1,3,⚠️ À réactiver
13054.0,318,1,-14.0,1,1,1,3,⚠️ À réactiver
13055.0,45,2,1090.55,3,2,4,9,🔄 Moyen
13056.0,187,1,209.48,1,1,1,3,⚠️ À réactiver
13057.0,166,4,540.74,2,3,3,8,🔄 Moyen
13059.0,49,11,2089.22,3,5,5,13,🏆 VIP
13063.0,116,1,188.4,2,1,1,4,⚠️ À réactiver
13064.0,186,2,561.25,1,2,3,6,⚠️ À réactiver
13065.0,9,6,1050.1,5,4,4,13,🏆 VIP
13067.0,45,2,393.05,3,2,2,7,🔄 Moyen
13069.0,5,17,5029.65,5,5,5,15,🏆 VIP
13070.0,95,4,515.1,2,3,3,8,🔄 Moyen
13071.0,248,1,129.22,1,1,1,3,⚠️ À réactiver
13073.0,47,2,418.08,3,2,2,7,🔄 Moyen
13074.0,147,5,1362.8400000000001,2,4,4,10,⭐ Fidèle
13076.0,93,1,135.4,2,1,1,4,⚠️ À réactiver
13077.0,2,11,2310.9,5,5,5,15,🏆 VIP
13078.0,2,53,16451.55,5,5,5,15,🏆 VIP
13079.0,53,1,199.08,3,1,1,5,⚠️ À réactiver
13080.0,37,4,202.75,3,3,1,7,🔄 Moyen
13081.0,7,25,30363.67,5,5,5,15,🏆 VIP
13082.0,60,15,3673.44,3,5,5,13,🏆 VIP
13083.0,61,1,91.67999999999999,3,1,1,5,⚠️ À réactiver
13084.0,123,2,116.44999999999999,2,2,1,5,⚠️ À réactiver
13085.0,56,7,1187.08,3,4,4,11,⭐ Fidèle
13086.0,18,1,439.33,4,1,2,7,🔄 Moyen
13087.0,362,1,313.64,1,1,2,4,⚠️ À réactiver
13088.0,53,1,236.11,3,1,2,6,⚠️ À réactiver
13089.0,4,132,55828.31,5,5,5,15,🏆 VIP
13090.0,1,15,5081.89,5,5,5,15,🏆 VIP
13091.0,365,4,-450.03999999999996,1,3,1,5,⚠️ À réactiver
13092.0,50,9,1547.5,3,5,4,12,⭐ Fidèle
13093.0,9,76,46332.26,5,5,5,15,🏆 VIP
13094.0,4,2,505.79999999999995,5,2,3,10,⭐ Fidèle
13096.0,30,1,419.7,4,1,2,7,🔄 Moyen
13097.0,24,26,6968.41,4,5,5,14,🏆 VIP
13100.0,260,1,-1598.67,1,1,1,3,⚠️ À réactiver
13101.0,134,3,594.21,2,3,3,8,🔄 Moyen
13102.0,1,16,5103.83,5,5,5,15,🏆 VIP
13103.0,73,2,465.7,2,2,2,6,⚠️ À réactiver
13104.0,51,3,610.62,3,3,3,9,🔄 Moyen
13105.0,72,1,72.0,2,1,1,4,⚠️ À réactiver
13106.0,49,1,526.96,3,1,3,7,🔄 Moyen
13107.0,45,10,3585.55,3,5,5,13,🏆 VIP
13108.0,8,2,748.46,5,2,3,10,⭐ Fidèle
13109.0,185,2,340.74,1,2,2,5,⚠️ À réactiver
13110.0,73,6,1443.3,2,4,4,10,⭐ Fidèle
13111.0,354,1,321.88000000000005,1,1,2,4,⚠️ À réactiver
13112.0,177,3,-5.44,2,3,1,6,⚠️ À réactiver
13113.0,2,22,6090.25,5,5,5,15,🏆 VIP
13114.0,366,1,234.38,1,1,2,4,⚠️ À réactiver
13115.0,2,10,3168.82,5,5,5,15,🏆 VIP
13117.0,1,13,1657.2,5,5,4,14,🏆 VIP
13118.0,12,5,1209.1,5,4,4,13,🏆 VIP
13119.0,304,1,134.9,1,1,1,3,⚠️ À réactiver
13123.0,108,2,506.75,2,2,3,7,🔄 Moyen
13124.0,21,1,916.12,4,1,3,8,🔄 Moyen
13125.0,159,1,158.57,2,1,1,4,⚠️ À réactiver
13126.0,2,11,1846.18,5,5,4,14,🏆 VIP
13128.0,267,1,263.5,1,1,2,4,⚠️ À réactiver
13129.0,88,2,233.25,2,2,2,6,⚠️ À réactiver
13131.0,54,4,2240.47,3,3,5,11,⭐ Fidèle
13133.0,95,1,90.65,2,1,1,4,⚠️ À réactiver
13134.0,38,2,681.65,3,2,3,8,🔄 Moyen
13135.0,127,1,275.45,2,1,2,5,⚠️ À réactiver
13136.0,1,14,3532.42,5,5,5,15,🏆 VIP
13137.0,22,8,4062.29,4,5,5,14,🏆 VIP
13138.0,8,3,492.1,5,3,3,11,⭐ Fidèle
13139.0,73,1,3138.04,2,1,5,8,🔄 Moyen
13140.0,2,3,791.96,5,3,3,11,⭐ Fidèle
13141.0,21,15,5150.83,4,5,5,14,🏆 VIP
13143.0,218,2,399.2,1,2,2,5,⚠️ À réactiver
13144.0,67,1,24.4,3,1,1,5,⚠️ À réactiver
13145.0,8,4,805.0,5,3,3,11,⭐ Fidèle
13148.0,25,19,4775.12,4,5,5,14,🏆 VIP
13150.0,106,4,435.02,2,3,2,7,🔄 Moyen
13151.0,261,3,1261.32,1,3,4,8,🔄 Moyen
13152.0,53,9,2114.98,3,5,5,13,🏆 VIP
13154.0,35,4,1609.29,4,3,4,11,⭐ Fidèle
13155.0,4,3,778.42,5,3,3,11,⭐ Fidèle
13156.0,21,3,1586.54,4,3,4,11,⭐ Fidèle
13157.0,45,5,3946.14,3,4,5,12,⭐ Fidèle
13158.0,24,1,307.12,4,1,2,7,🔄 Moyen
13161.0,136,1,366.13,2,1,2,5,⚠️ À réactiver
13162.0,16,14,7471.95,4,5,5,14,🏆 VIP
13163.0,246,2,0.0,1,2,1,4,⚠️ À réactiver
13164.0,205,3,297.46000000000004,1,3,2,6,⚠️ À réactiver
13165.0,49,1,429.68,3,1,2,6,⚠️ À réactiver
13166.0,50,1,466.98,3,1,2,6,⚠️ À réactiver
13167.0,26,1,333.82,4,1,2,7,🔄 Moyen
13168.0,178,1,556.12,1,1,3,5,⚠️ À réactiver
13169.0,198,1,127.2,1,1,1,3,⚠️ À réactiver
13172.0,36,1,69.6,3,1,1,5,⚠️ À réactiver
13173.0,3,12,2266.85,5,5,5,15,🏆 VIP
13174.0,5,10,6677.81,5,5,5,15,🏆 VIP
13175.0,190,4,793.1,1,3,3,7,🔄 Moyen
13177.0,66,1,229.75,3,1,1,5,⚠️ À réactiver
13178.0,33,14,8272.42,4,5,5,14,🏆 VIP
13179.0,254,1,572.31,1,1,3,5,⚠️ À réactiver
13180.0,243,1,86.1,1,1,1,3,⚠️ À réactiver
13181.0,17,1,359.69,4,1,2,7,🔄 Moyen
13183.0,30,9,3053.1,4,5,5,14,🏆 VIP
13187.0,260,4,112.29,1,3,1,5,⚠️ À réactiver
13190.0,180,4,518.76,1,3,3,7,🔄 Moyen
13191.0,294,1,164.69,1,1,1,3,⚠️ À réactiver
13192.0,154,6,1632.59,2,4,4,10,⭐ Fidèle
13194.0,57,1,412.08,3,1,2,6,⚠️ À réactiver
13195.0,50,1,172.38,3,1,1,5,⚠️ À réactiver
13196.0,79,4,1261.86,2,3,4,9,🔄 Moyen
13197.0,245,1,373.01,1,1,2,4,⚠️ À réactiver
13198.0,21,4,1528.19,4,3,4,11,⭐ Fidèle
13199.0,2,31,6601.02,5,5,5,15,🏆 VIP
13201.0,138,4,1240.61,2,3,4,9,🔄 Moyen
13202.0,14,8,1571.3500000000001,5,5,4,14,🏆 VIP
13203.0,22,7,1761.09,4,4,4,12,⭐ Fidèle
13204.0,367,1,966.66,1,1,4,6,⚠️ À réactiver
13205.0,79,1,2803.2,2,1,5,8,🔄 Moyen
13206.0,36,15,8280.13,3,5,5,13,🏆 VIP
13207.0,87,2,285.6,2,2,2,6,⚠️ À réactiver
13208.0,85,3,764.6,2,3,3,8,🔄 Moyen
13209.0,150,5,2617.9,2,4,5,11,⭐ Fidèle
13211.0,17,9,1509.45,4,5,4,13,🏆 VIP
13213.0,14,8,2316.19,5,5,5,15,🏆 VIP
13214.0,53,7,3264.23,3,4,5,12,⭐ Fidèle
13215.0,38,1,81.6,3,1,1,5,⚠️ À réactiver
13217.0,291,1,132.5,1,1,1,3,⚠️ À réactiver
13219.0,254,1,76.23,1,1,1,3,⚠️ À réactiver
13220.0,211,1,516.8,1,1,3,5,⚠️ À réactiver
13222.0,213,1,88.5,1,1,1,3,⚠️ À réactiver
13223.0,59,4,805.92,3,3,3,9,🔄 Moyen
13225.0,57,9,9796.23,3,5,5,13,🏆 VIP
13226.0,29,1,204.25,4,1,1,6,⚠️ À réactiver
13230.0,1,17,3553.81,5,5,5,15,🏆 VIP
13231.0,182,1,-355.2,1,1,1,3,⚠️ À réactiver
13233.0,56,2,571.34,3,2,3,8,🔄 Moyen
13234.0,308,2,356.95,1,2,2,5,⚠️ À réactiver
13237.0,23,1,643.0,4,1,3,8,🔄 Moyen
13238.0,66,2,305.9,3,2,2,7,🔄 Moyen
13239.0,73,5,1250.28,2,4,4,10,⭐ Fidèle
13240.0,1,6,997.52,5,4,4,13,🏆 VIP
13241.0,47,1,115.58,3,1,1,5,⚠️ À réactiver
13242.0,87,4,429.0,2,3,2,7,🔄 Moyen
13243.0,85,4,677.97,2,3,3,8,🔄 Moyen
13245.0,68,1,558.72,3,1,3,7,🔄 Moyen
13246.0,29,7,1355.58,4,4,4,12,⭐ Fidèle
13249.0,37,6,897.52,3,4,3,10,⭐ Fidèle
13250.0,88,3,248.54,2,3,2,7,🔄 Moyen
13251.0,38,1,252.68,3,1,2,6,⚠️ À réactiver
13252.0,30,3,341.3,4,3,2,9,🔄 Moyen
13253.0,66,2,1920.71,3,2,4,9,🔄 Moyen
13254.0,12,1,51.41,5,1,1,7,🔄 Moyen
13255.0,9,2,504.95,5,2,3,10,⭐ Fidèle
13257.0,63,3,117.94999999999999,3,3,1,7,🔄 Moyen
13258.0,15,2,336.59999999999997,5,2,2,9,🔄 Moyen
13259.0,33,8,1141.06,4,5,4,13,🏆 VIP
13262.0,25,2,373.15999999999997,4,2,2,8,🔄 Moyen
13263.0,29,4,1250.6200000000001,4,3,4,11,⭐ Fidèle
13264.0,78,1,722.56,2,1,3,6,⚠️ À réactiver
13266.0,31,11,2247.63,4,5,5,14,🏆 VIP
13267.0,2,25,5107.7699999999995,5,5,5,15,🏆 VIP
13269.0,5,14,3545.47,5,5,5,15,🏆 VIP
13270.0,2,1,590.0,5,1,3,9,🔄 Moyen
13274.0,45,1,360.85,3,1,2,6,⚠️ À réactiver
13275.0,19,2,241.66,4,2,2,8,🔄 Moyen
13276.0,33,5,1327.63,4,4,4,12,⭐ Fidèle
13277.0,16,3,264.9,4,3,2,9,🔄 Moyen
13278.0,35,4,885.47,4,3,3,10,⭐ Fidèle
13280.0,15,5,1482.27,5,4,4,13,🏆 VIP
13281.0,73,3,306.45,2,3,2,7,🔄 Moyen
13282.0,42,1,181.05,3,1,1,5,⚠️ À réactiver
13283.0,203,2,279.7,1,2,2,5,⚠️ À réactiver
13285.0,236,2,655.47,1,2,3,6,⚠️ À réactiver
13286.0,236,1,734.91,1,1,3,5,⚠️ À réactiver
13287.0,219,7,519.67,1,4,3,8,🔄 Moyen
13288.0,79,6,892.16,2,4,3,9,🔄 Moyen
13289.0,359,1,307.95,1,1,2,4,⚠️ À réactiver
13290.0,66,3,-208.63,3,3,1,7,🔄 Moyen
13291.0,50,10,2959.73,3,5,5,13,🏆 VIP
13292.0,46,4,408.85,3,3,2,8,🔄 Moyen
13293.0,28,7,1180.34,4,4,4,12,⭐ Fidèle
13294.0,282,1,815.79,1,1,3,5,⚠️ À réactiver
13295.0,8,8,860.0699999999999,5,5,3,13,🏆 VIP
13296.0,59,5,705.11,3,4,3,10,⭐ Fidèle
13297.0,21,4,2262.82,4,3,5,12,⭐ Fidèle
13299.0,49,4,1030.8,3,3,4,10,⭐ Fidèle
13300.0,24,3,901.92,4,3,3,10,⭐ Fidèle
13302.0,162,1,95.45,2,1,1,4,⚠️ À réactiver
13303.0,36,1,61.72,3,1,1,5,⚠️ À réactiver
13304.0,84,6,820.37,2,4,3,9,🔄 Moyen
13305.0,8,7,1753.85,5,4,4,13,🏆 VIP
13306.0,66,1,53.65,3,1,1,5,⚠️ À réactiver
13307.0,123,2,258.34,2,2,2,6,⚠️ À réactiver
13308.0,232,1,284.86,1,1,2,4,⚠️ À réactiver
13309.0,28,1,249.57999999999998,4,1,2,7,🔄 Moyen
13310.0,16,2,409.17,4,2,2,8,🔄 Moyen
13312.0,87,1,124.75,2,1,1,4,⚠️ À réactiver
13313.0,115,10,1867.95,2,5,4,11,⭐ Fidèle
13315.0,325,1,310.26,1,1,2,4,⚠️ À réactiver
13316.0,28,7,7091.4400000000005,4,4,5,13,🏆 VIP
13317.0,15,22,3928.46,5,5,5,15,🏆 VIP
13319.0,1,45,11041.75,5,5,5,15,🏆 VIP
13320.0,64,3,669.25,3,3,3,9,🔄 Moyen
13324.0,64,11,3348.57,3,5,5,13,🏆 VIP
13326.0,68,1,281.76,3,1,2,6,⚠️ À réactiver
13327.0,1,15,6123.46,5,5,5,15,🏆 VIP
13329.0,2,11,4236.62,5,5,5,15,🏆 VIP
13330.0,91,3,1665.25,2,3,4,9,🔄 Moyen
13331.0,37,1,262.4,3,1,2,6,⚠️ À réactiver
13333.0,47,3,1015.74,3,3,4,10,⭐ Fidèle
13334.0,172,3,2720.18,2,3,5,10,⭐ Fidèle
13335.0,176,1,-955.06,2,1,1,4,⚠️ À réactiver
13337.0,154,2,1548.55,2,2,4,8,🔄 Moyen
13338.0,169,7,1791.8,2,4,4,10,⭐ Fidèle
13340.0,53,5,11364.08,3,4,5,12,⭐ Fidèle
13342.0,218,1,-14.100000000000001,1,1,1,3,⚠️ À réactiver
13346.0,98,6,299.4,2,4,2,8,🔄 Moyen
13353.0,24,1,-28.849999999999998,4,1,1,6,⚠️ À réactiver
13357.0,130,4,3228.41,2,3,5,10,⭐ Fidèle
13359.0,29,2,570.6999999999999,4,2,3,9,🔄 Moyen
13360.0,64,7,1464.1,3,4,4,11,⭐ Fidèle
13361.0,108,2,1450.5,2,2,4,8,🔄 Moyen
13362.0,14,5,2272.08,5,4,5,14,🏆 VIP
13363.0,45,1,731.36,3,1,3,7,🔄 Moyen
13365.0,29,1,-26.9,4,1,1,6,⚠️ À réactiver
13367.0,67,1,510.2,3,1,3,7,🔄 Moyen
13368.0,50,3,462.7,3,3,2,8,🔄 Moyen
13369.0,1,1,308.28,5,1,2,8,🔄 Moyen
13370.0,2,2,721.3199999999999,5,2,3,10,⭐ Fidèle
13371.0,134,4,2271.46,2,3,5,10,⭐ Fidèle
13373.0,51,3,4274.94,3,3,5,11,⭐ Fidèle
13374.0,50,2,422.8,3,2,2,7,🔄 Moyen
13375.0,80,1,1013.58,2,1,4,7,🔄 Moyen
13377.0,32,4,1495.43,4,3,4,11,⭐ Fidèle
13378.0,58,1,-756.4,3,1,1,5,⚠️ À réactiver
13380.0,68,1,62.4,3,1,1,5,⚠️ À réactiver
13381.0,15,8,4558.21,5,5,5,15,🏆 VIP
13382.0,64,4,1164.59,3,3,4,10,⭐ Fidèle
13383.0,179,1,305.28,1,1,2,4,⚠️ À réactiver
13384.0,26,6,2512.81,4,4,5,13,🏆 VIP
13386.0,50,2,835.46,3,2,3,8,🔄 Moyen
13387.0,53,1,189.44,3,1,1,5,⚠️ À réactiver
13388.0,239,1,508.55,1,1,3,5,⚠️ À réactiver
13392.0,313,1,91.14,1,1,1,3,⚠️ À réactiver
13393.0,219,6,1105.85,1,4,4,9,🔄 Moyen
13394.0,15,14,4011.08,5,5,5,15,🏆 VIP
13395.0,36,2,872.51,3,2,3,8,🔄 Moyen
13397.0,73,7,1554.93,2,4,4,10,⭐ Fidèle
13398.0,84,1,213.0,2,1,1,4,⚠️ À réactiver
13399.0,100,3,275.4,2,3,2,7,🔄 Moyen
13400.0,210,2,300.93,1,2,2,5,⚠️ À réactiver
13401.0,260,1,-1834.14,1,1,1,3,⚠️ À réactiver
13402.0,8,3,913.9,5,3,3,11,⭐ Fidèle
13403.0,23,2,154.5,4,2,1,7,🔄 Moyen
13405.0,109,6,624.11,2,4,3,9,🔄 Moyen
13406.0,63,3,557.22,3,3,3,9,🔄 Moyen
13407.0,214,6,2111.89,1,4,5,10,⭐ Fidèle
13408.0,7,57,23365.44,5,5,5,15,🏆 VIP
13409.0,260,1,-525.65,1,1,1,3,⚠️ À réactiver
13410.0,29,5,1183.6,4,4,4,12,⭐ Fidèle
13412.0,256,1,487.35,1,1,3,5,⚠️ À réactiver
13413.0,275,8,345.8,1,5,2,8,🔄 Moyen
13414.0,99,4,1091.74,2,3,4,9,🔄 Moyen
13415.0,108,5,681.92,2,4,3,9,🔄 Moyen
13416.0,372,1,228.3,1,1,1,3,⚠️ À réactiver
13417.0,183,5,953.06,1,4,4,9,🔄 Moyen
13418.0,8,16,6070.72,5,5,5,15,🏆 VIP
13421.0,42,8,2239.84,3,5,5,13,🏆 VIP
13423.0,64,1,217.03,3,1,1,5,⚠️ À réactiver
13424.0,80,2,557.92,2,2,3,7,🔄 Moyen
13425.0,144,5,1751.72,2,4,4,10,⭐ Fidèle
13426.0,18,12,4526.0599999999995,4,5,5,14,🏆 VIP
13427.0,113,3,423.93,2,3,2,7,🔄 Moyen
13428.0,150,2,281.51,2,2,2,6,⚠️ À réactiver
13431.0,42,7,2020.1399999999999,3,4,4,11,⭐ Fidèle
13432.0,207,2,439.1,1,2,2,5,⚠️ À réactiver
13433.0,73,5,656.87,2,4,3,9,🔄 Moyen
13434.0,21,3,1132.62,4,3,4,11,⭐ Fidèle
13435.0,12,2,665.34,5,2,3,10,⭐ Fidèle
13438.0,183,1,46.5,1,1,1,3,⚠️ À réactiver
13439.0,24,2,702.9,4,2,3,9,🔄 Moyen
13440.0,59,10,1213.95,3,5,4,12,⭐ Fidèle
13441.0,67,1,424.26,3,1,2,6,⚠️ À réactiver
13442.0,303,3,419.87,1,3,2,6,⚠️ À réactiver
13443.0,84,7,1247.71,2,4,4,10,⭐ Fidèle
13444.0,10,2,631.68,5,2,3,10,⭐ Fidèle
13445.0,262,1,241.89999999999998,1,1,2,4,⚠️ À réactiver
13446.0,56,18,3608.86,3,5,5,13,🏆 VIP
13448.0,9,11,4982.08,5,5,5,15,🏆 VIP
13450.0,10,8,2073.82,5,5,5,15,🏆 VIP
13451.0,17,7,4203.5199999999995,4,4,5,13,🏆 VIP
13452.0,108,1,139.8,2,1,1,4,⚠️ À réactiver
13453.0,29,3,402.01,4,3,2,9,🔄 Moyen
13454.0,277,1,219.87,1,1,1,3,⚠️ À réactiver
13455.0,2,8,1766.47,5,5,4,14,🏆 VIP
13457.0,324,4,143.26999999999998,1,3,1,5,⚠️ À réactiver
13458.0,15,2,2312.7,5,2,5,12,⭐ Fidèle
13459.0,260,2,1160.41,1,2,4,7,🔄 Moyen
13461.0,36,5,2693.5,3,4,5,12,⭐ Fidèle
13462.0,46,4,1002.35,3,3,4,10,⭐ Fidèle
13463.0,56,1,-158.65,3,1,1,5,⚠️ À réactiver
13464.0,30,6,2409.21,4,4,5,13,🏆 VIP
13465.0,82,2,931.12,2,2,3,7,🔄 Moyen
13466.0,32,5,654.3,4,4,3,11,⭐ Fidèle
13468.0,4,49,7434.86,5,5,5,15,🏆 VIP
13469.0,289,1,82.4,1,1,1,3,⚠️ À réactiver
13472.0,99,2,592.24,2,2,3,7,🔄 Moyen
13473.0,210,7,1993.44,1,4,4,9,🔄 Moyen
13474.0,79,2,434.2,2,2,2,6,⚠️ À réactiver
13476.0,42,3,823.0,3,3,3,9,🔄 Moyen
13477.0,91,5,1379.59,2,4,4,10,⭐ Fidèle
13478.0,105,7,2068.03,2,4,5,11,⭐ Fidèle
13479.0,85,4,517.5,2,3,3,8,🔄 Moyen
13480.0,52,2,627.8199999999999,3,2,3,8,🔄 Moyen
13481.0,4,7,2022.03,5,4,4,13,🏆 VIP
13482.0,263,1,151.45,1,1,1,3,⚠️ À réactiver
13484.0,19,3,453.52,4,3,2,9,🔄 Moyen
13485.0,12,14,2503.68,5,5,5,15,🏆 VIP
13487.0,141,2,271.47,2,2,2,6,⚠️ À réactiver
13488.0,3,13,6603.12,5,5,5,15,🏆 VIP
13490.0,290,1,154.25,1,1,1,3,⚠️ À réactiver
13491.0,8,18,3350.74,5,5,5,15,🏆 VIP
13495.0,2,9,3256.49,5,5,5,15,🏆 VIP
13497.0,4,6,945.28,5,4,4,13,🏆 VIP
13498.0,366,1,327.38,1,1,2,4,⚠️ À réactiver
13500.0,37,1,299.53,3,1,2,6,⚠️ À réactiver
13501.0,122,3,1529.79,2,3,4,9,🔄 Moyen
13502.0,46,3,482.59999999999997,3,3,3,9,🔄 Moyen
13503.0,115,11,1576.69,2,5,4,11,⭐ Fidèle
13506.0,5,6,1156.83,5,4,4,13,🏆 VIP
13508.0,278,1,176.07999999999998,1,1,1,3,⚠️ À réactiver
13509.0,143,1,135.0,2,1,1,4,⚠️ À réactiver
13510.0,11,12,2703.23,5,5,5,15,🏆 VIP
13511.0,119,2,244.61,2,2,2,6,⚠️ À réactiver
13512.0,23,3,462.18,4,3,2,9,🔄 Moyen
13513.0,77,3,591.89,2,3,3,8,🔄 Moyen
13514.0,64,3,663.7,3,3,3,9,🔄 Moyen
13515.0,85,2,374.7,2,2,2,6,⚠️ À réactiver
13516.0,53,1,295.85,3,1,2,6,⚠️ À réactiver
13519.0,78,1,220.46,2,1,1,4,⚠️ À réactiver
13520.0,7,8,3192.9,5,5,5,15,🏆 VIP
13523.0,2,2,1136.64,5,2,4,11,⭐ Fidèle
13526.0,374,4,942.6,1,3,4,8,🔄 Moyen
13527.0,54,6,2386.28,3,4,5,12,⭐ Fidèle
13528.0,318,1,-40.0,1,1,1,3,⚠️ À réactiver
13530.0,270,1,402.98,1,1,2,4,⚠️ À réactiver
13531.0,2,5,1254.72,5,4,4,13,🏆 VIP
13534.0,10,17,1711.42,5,5,4,14,🏆 VIP
13535.0,38,1,89.5,3,1,1,5,⚠️ À réactiver
13537.0,61,2,717.85,3,2,3,8,🔄 Moyen
13538.0,32,5,1831.88,4,4,4,12,⭐ Fidèle
13539.0,56,5,925.42,3,4,3,10,⭐ Fidèle
13540.0,103,3,632.39,2,3,3,8,🔄 Moyen
13541.0,59,3,717.9,3,3,3,9,🔄 Moyen
13542.0,12,18,3970.77,5,5,5,15,🏆 VIP
13543.0,270,2,1439.61,1,2,4,7,🔄 Moyen
13544.0,47,5,529.09,3,4,3,10,⭐ Fidèle
13545.0,26,3,347.35,4,3,2,9,🔄 Moyen
13546.0,18,2,465.15,4,2,2,8,🔄 Moyen
13547.0,44,1,175.53,3,1,1,5,⚠️ À réactiver
13548.0,107,1,226.57999999999998,2,1,1,4,⚠️ À réactiver
13549.0,23,1,87.6,4,1,1,6,⚠️ À réactiver
13550.0,19,1,349.51,4,1,2,7,🔄 Moyen
13551.0,302,1,152.4,1,1,1,3,⚠️ À réactiver
13552.0,45,16,3079.1,3,5,5,13,🏆 VIP
13553.0,310,1,517.8,1,1,3,5,⚠️ À réactiver
13554.0,16,10,1556.3899999999999,4,5,4,13,🏆 VIP
13555.0,14,12,4757.06,5,5,5,15,🏆 VIP
13556.0,65,2,200.82,3,2,1,6,⚠️ À réactiver
13557.0,30,14,2396.02,4,5,5,14,🏆 VIP
13559.0,148,2,990.0,2,2,4,8,🔄 Moyen
13561.0,33,10,1678.86,4,5,4,13,🏆 VIP
13562.0,37,5,3038.85,3,4,5,12,⭐ Fidèle
13564.0,4,50,15138.98,5,5,5,15,🏆 VIP
13565.0,47,1,174.57999999999998,3,1,1,5,⚠️ À réactiver
13566.0,70,3,833.41,3,3,3,9,🔄 Moyen
13567.0,64,5,1078.59,3,4,4,11,⭐ Fidèle
13569.0,3,3,520.03,5,3,3,11,⭐ Fidèle
13571.0,18,14,2454.22,4,5,5,14,🏆 VIP
13573.0,15,4,622.07,5,3,3,11,⭐ Fidèle
13574.0,47,1,421.25,3,1,2,6,⚠️ À réactiver
13576.0,9,13,4812.85,5,5,5,15,🏆 VIP
13577.0,18,9,1688.32,4,5,4,13,🏆 VIP
13578.0,45,1,147.66,3,1,1,5,⚠️ À réactiver
13579.0,5,5,1068.8,5,4,4,13,🏆 VIP
13580.0,42,1,107.75,3,1,1,5,⚠️ À réactiver
13581.0,50,1,162.53,3,1,1,5,⚠️ À réactiver
13582.0,25,2,241.68,4,2,2,8,🔄 Moyen
13583.0,315,1,664.0,1,1,3,5,⚠️ À réactiver
13584.0,134,4,204.75,2,3,1,6,⚠️ À réactiver
13585.0,166,4,674.46,2,3,3,8,🔄 Moyen
13586.0,177,1,131.53,2,1,1,4,⚠️ À réactiver
13587.0,85,3,961.1,2,3,4,9,🔄 Moyen
13589.0,85,4,741.09,2,3,3,8,🔄 Moyen
13590.0,11,14,4322.17,5,5,5,15,🏆 VIP
13591.0,71,5,964.06,2,4,4,10,⭐ Fidèle
13593.0,23,10,3484.93,4,5,5,14,🏆 VIP
13594.0,121,2,111.45,2,2,1,5,⚠️ À réactiver
13595.0,152,3,818.22,2,3,3,8,🔄 Moyen
13597.0,24,3,372.21,4,3,2,9,🔄 Moyen
13598.0,131,4,609.42,2,3,3,8,🔄 Moyen
13599.0,2,21,4759.74,5,5,5,15,🏆 VIP
13600.0,270,1,298.9,1,1,2,4,⚠️ À réactiver
13601.0,28,2,491.82,4,2,3,9,🔄 Moyen
13602.0,17,3,596.28,4,3,3,10,⭐ Fidèle
13604.0,288,2,713.39,1,2,3,6,⚠️ À réactiver
13605.0,23,2,522.67,4,2,3,9,🔄 Moyen
13607.0,28,2,382.6,4,2,2,8,🔄 Moyen
13608.0,176,1,236.2,2,1,2,5,⚠️ À réactiver
13609.0,229,1,167.35,1,1,1,3,⚠️ À réactiver
13610.0,23,8,1028.7,4,5,4,13,🏆 VIP
13611.0,10,10,2122.83,5,5,5,15,🏆 VIP
13612.0,154,2,777.79,2,2,3,7,🔄 Moyen
13613.0,88,5,1039.85,2,4,4,10,⭐ Fidèle
13614.0,29,2,748.73,4,2,3,9,🔄 Moyen
13615.0,30,10,5812.24,4,5,5,14,🏆 VIP
13616.0,204,2,288.1,1,2,2,5,⚠️ À réactiver
13617.0,44,6,719.62,3,4,3,10,⭐ Fidèle
13619.0,180,2,231.69,1,2,2,5,⚠️ À réactiver
13620.0,164,1,112.34,2,1,1,4,⚠️ À réactiver
13622.0,324,2,651.45,1,2,3,6,⚠️ À réactiver
13623.0,16,8,1773.92,4,5,4,13,🏆 VIP
13624.0,17,2,427.18,4,2,2,8,🔄 Moyen
13625.0,232,1,301.26,1,1,2,4,⚠️ À réactiver
13626.0,10,2,432.26,5,2,2,9,🔄 Moyen
13627.0,124,3,593.53,2,3,3,8,🔄 Moyen
13628.0,312,1,310.14,1,1,2,4,⚠️ À réactiver
13629.0,49,8,5578.5,3,5,5,13,🏆 VIP
13632.0,30,4,1517.68,4,3,4,11,⭐ Fidèle
13633.0,239,1,-306.66,1,1,1,3,⚠️ À réactiver
13634.0,10,12,2944.39,5,5,5,15,🏆 VIP
13635.0,73,5,1877.19,2,4,4,10,⭐ Fidèle
13639.0,72,1,312.93,2,1,2,5,⚠️ À réactiver
13640.0,247,1,405.0,1,1,2,4,⚠️ À réactiver
13641.0,276,7,921.8199999999999,1,4,3,8,🔄 Moyen
13642.0,68,4,147.17,3,3,1,7,🔄 Moyen
13643.0,16,12,1592.73,4,5,4,13,🏆 VIP
13646.0,35,3,323.3,4,3,2,9,🔄 Moyen
13647.0,130,4,1393.56,2,3,4,9,🔄 Moyen
13648.0,36,11,1679.01,3,5,4,12,⭐ Fidèle
13649.0,2,5,1332.28,5,4,4,13,🏆 VIP
13650.0,10,9,1289.1599999999999,5,5,4,14,🏆 VIP
13651.0,17,2,114.75,4,2,1,7,🔄 Moyen
13652.0,4,3,1475.77,5,3,4,12,⭐ Fidèle
13653.0,123,1,152.2,2,1,1,4,⚠️ À réactiver
13654.0,16,5,3600.67,4,4,5,13,🏆 VIP
13655.0,10,6,1326.33,5,4,4,13,🏆 VIP
13656.0,94,5,673.7,2,4,3,9,🔄 Moyen
13658.0,19,6,3350.6,4,4,5,13,🏆 VIP
13659.0,52,14,3165.78,3,5,5,13,🏆 VIP
13660.0,31,2,303.69,4,2,2,8,🔄 Moyen
13661.0,239,1,325.24,1,1,2,4,⚠️ À réactiver
13662.0,21,10,1304.05,4,5,4,13,🏆 VIP
13663.0,16,5,1824.1399999999999,4,4,4,12,⭐ Fidèle
13664.0,318,1,-13.14,1,1,1,3,⚠️ À réactiver
13665.0,22,3,1711.66,4,3,4,11,⭐ Fidèle
13666.0,56,2,43.25,3,2,1,6,⚠️ À réactiver
13668.0,18,18,6533.07,4,5,5,14,🏆 VIP
13669.0,43,1,195.0,3,1,1,5,⚠️ À réactiver
13671.0,30,1,194.95,4,1,1,6,⚠️ À réactiver
13672.0,366,1,233.53,1,1,2,4,⚠️ À réactiver
13674.0,65,2,215.88,3,2,1,6,⚠️ À réactiver
13676.0,175,3,153.15,2,3,1,6,⚠️ À réactiver
13677.0,40,2,556.19,3,2,3,8,🔄 Moyen
13679.0,129,3,281.26,2,3,2,7,🔄 Moyen
13680.0,107,8,7713.25,2,5,5,12,⭐ Fidèle
13683.0,93,1,258.6,2,1,2,5,⚠️ À réactiver
13684.0,26,4,482.29,4,3,3,10,⭐ Fidèle
13686.0,16,2,337.04,4,2,2,8,🔄 Moyen
13687.0,74,1,11880.84,2,1,5,8,🔄 Moyen
13688.0,271,1,375.5,1,1,2,4,⚠️ À réactiver
13689.0,80,1,349.5,2,1,2,5,⚠️ À réactiver
13691.0,32,1,212.78,4,1,1,6,⚠️ À réactiver
13692.0,36,3,1549.58,3,3,4,10,⭐ Fidèle
13693.0,10,11,1980.32,5,5,4,14,🏆 VIP
13694.0,9,105,128172.42,5,5,5,15,🏆 VIP
13695.0,213,1,266.6,1,1,2,4,⚠️ À réactiver
13696.0,57,4,2008.6999999999998,3,3,4,10,⭐ Fidèle
13698.0,232,2,465.53000000000003,1,2,2,5,⚠️ À réactiver
13699.0,183,2,402.82,1,2,2,5,⚠️ À réactiver
13700.0,53,4,321.09,3,3,2,8,🔄 Moyen
13701.0,73,2,159.55,2,2,1,5,⚠️ À réactiver
13702.0,81,1,135.18,2,1,1,4,⚠️ À réactiver
13703.0,49,2,-6.217248937900877e-15,3,2,1,6,⚠️ À réactiver
13705.0,9,5,1323.47,5,4,4,13,🏆 VIP
13706.0,262,1,300.38,1,1,2,4,⚠️ À réactiver
13707.0,65,3,2559.45,3,3,5,11,⭐ Fidèle
13709.0,82,5,1263.7,2,4,4,10,⭐ Fidèle
13710.0,59,2,329.04,3,2,2,7,🔄 Moyen
13711.0,42,13,1380.55,3,5,4,12,⭐ Fidèle
13712.0,246,1,537.58,1,1,3,5,⚠️ À réactiver
13713.0,44,3,743.26,3,3,3,9,🔄 Moyen
13714.0,101,1,161.35,2,1,1,4,⚠️ À réactiver
13715.0,8,14,7384.4,5,5,5,15,🏆 VIP
13717.0,88,4,315.79,2,3,2,7,🔄 Moyen
13719.0,29,6,1773.57,4,4,4,12,⭐ Fidèle
13721.0,31,1,217.39999999999998,4,1,1,6,⚠️ À réactiver
13722.0,56,7,3260.0,3,4,5,12,⭐ Fidèle
13723.0,28,5,1009.35,4,4,4,12,⭐ Fidèle
13724.0,273,1,213.01,1,1,1,3,⚠️ À réactiver
13727.0,247,7,733.82,1,4,3,8,🔄 Moyen
13728.0,23,10,1839.03,4,5,4,13,🏆 VIP
13729.0,71,5,676.43,2,4,3,9,🔄 Moyen
13733.0,46,3,484.53,3,3,3,9,🔄 Moyen
13734.0,144,6,3451.29,2,4,5,11,⭐ Fidèle
13735.0,12,14,6706.63,5,5,5,15,🏆 VIP
13736.0,61,9,1991.01,3,5,4,12,⭐ Fidèle
13738.0,32,1,440.93,4,1,2,7,🔄 Moyen
13739.0,163,1,75.3,2,1,1,4,⚠️ À réactiver
13740.0,51,4,1247.02,3,3,4,10,⭐ Fidèle
13745.0,177,2,469.73,2,2,2,6,⚠️ À réactiver
13746.0,49,1,176.69,3,1,1,5,⚠️ À réactiver
13747.0,9,2,169.8,5,2,1,8,🔄 Moyen
13748.0,9,5,1320.1,5,4,4,13,🏆 VIP
13749.0,337,1,-10.25,1,1,1,3,⚠️ À réactiver
13750.0,10,8,1916.3400000000001,5,5,4,14,🏆 VIP
13752.0,163,1,404.45,2,1,2,5,⚠️ À réactiver
13753.0,234,3,1353.31,1,3,4,8,🔄 Moyen
13754.0,73,1,164.45,2,1,1,4,⚠️ À réactiver
13756.0,3,11,4002.08,5,5,5,15,🏆 VIP
13757.0,310,1,195.55,1,1,1,3,⚠️ À réactiver
13758.0,2,14,6072.59,5,5,5,15,🏆 VIP
13760.0,40,4,1071.85,3,3,4,10,⭐ Fidèle
13761.0,138,4,881.52,2,3,3,8,🔄 Moyen
13762.0,229,4,2165.7599999999998,1,3,5,9,🔄 Moyen
13763.0,24,3,3492.53,4,3,5,12,⭐ Fidèle
13764.0,205,3,1431.5,1,3,4,8,🔄 Moyen
13765.0,289,1,352.82,1,1,2,4,⚠️ À réactiver
13766.0,131,1,190.35,2,1,1,4,⚠️ À réactiver
13767.0,5,48,18169.97,5,5,5,15,🏆 VIP
13768.0,199,8,758.0699999999999,1,5,3,9,🔄 Moyen
13769.0,3,14,2994.7599999999998,5,5,5,15,🏆 VIP
13770.0,58,4,785.37,3,3,3,9,🔄 Moyen
13771.0,169,5,3094.37,2,4,5,11,⭐ Fidèle
13772.0,31,6,1962.59,4,4,4,12,⭐ Fidèle
13773.0,32,2,301.54,4,2,2,8,🔄 Moyen
13775.0,226,1,1049.66,1,1,4,6,⚠️ À réactiver
13776.0,64,8,-340.17,3,5,1,9,🔄 Moyen
13777.0,1,42,30268.22,5,5,5,15,🏆 VIP
13778.0,127,4,937.84,2,3,3,8,🔄 Moyen
13779.0,151,1,161.13,2,1,1,4,⚠️ À réactiver
13780.0,43,1,375.81,3,1,2,6,⚠️ À réactiver
13781.0,228,3,643.04,1,3,3,7,🔄 Moyen
13782.0,89,8,873.77,2,5,3,10,⭐ Fidèle
13783.0,123,4,1542.09,2,3,4,9,🔄 Moyen
13784.0,70,4,434.39,3,3,2,8,🔄 Moyen
13785.0,64,4,542.49,3,3,3,9,🔄 Moyen
13786.0,3,8,2506.01,5,5,5,15,🏆 VIP
13787.0,92,7,864.66,2,4,3,9,🔄 Moyen
13788.0,141,1,3.75,2,1,1,4,⚠️ À réactiver
13789.0,24,1,239.46,4,1,2,7,🔄 Moyen
13792.0,58,1,188.4,3,1,1,5,⚠️ À réactiver
13793.0,282,1,96.0,1,1,1,3,⚠️ À réactiver
13794.0,182,1,126.03,1,1,1,3,⚠️ À réactiver
13795.0,24,4,836.3,4,3,3,10,⭐ Fidèle
13796.0,135,1,289.7,2,1,2,5,⚠️ À réactiver
13797.0,72,4,1168.45,2,3,4,9,🔄 Moyen
13798.0,8,63,37222.05,5,5,5,15,🏆 VIP
13799.0,73,11,1350.96,2,5,4,11,⭐ Fidèle
13800.0,66,2,1121.24,3,2,4,9,🔄 Moyen
13802.0,10,18,21585.29,5,5,5,15,🏆 VIP
13803.0,67,3,1042.04,3,3,4,10,⭐ Fidèle
13804.0,71,2,572.73,2,2,3,7,🔄 Moyen
13807.0,3,4,397.3,5,3,2,10,⭐ Fidèle
13809.0,30,2,524.65,4,2,3,9,🔄 Moyen
13813.0,157,7,1333.01,2,4,4,10,⭐ Fidèle
13814.0,149,2,676.95,2,2,3,7,🔄 Moyen
13815.0,32,5,3270.88,4,4,5,13,🏆 VIP
13818.0,65,1,61.28,3,1,1,5,⚠️ À réactiver
13819.0,305,4,1490.75,1,3,4,8,🔄 Moyen
13820.0,54,5,640.4,3,4,3,10,⭐ Fidèle
13821.0,28,5,1001.39,4,4,4,12,⭐ Fidèle
13823.0,15,6,2400.89,5,4,5,14,🏆 VIP
13824.0,15,9,1574.42,5,5,4,14,🏆 VIP
13825.0,257,2,255.59,1,2,2,5,⚠️ À réactiver
13829.0,57,1,102.0,3,1,1,5,⚠️ À réactiver
13830.0,210,2,135.95000000000002,1,2,1,4,⚠️ À réactiver
13831.0,5,15,4806.19,5,5,5,15,🏆 VIP
13832.0,58,1,561.49,3,1,3,7,🔄 Moyen
13833.0,40,1,316.56,3,1,2,6,⚠️ À réactiver
13834.0,212,3,247.89,1,3,2,6,⚠️ À réactiver
13835.0,155,4,210.25,2,3,1,6,⚠️ À réactiver
13836.0,35,3,602.52,4,3,3,10,⭐ Fidèle
13838.0,5,7,1274.36,5,4,4,13,🏆 VIP
13839.0,122,1,139.95000000000002,2,1,1,4,⚠️ À réactiver
13840.0,52,1,651.4,3,1,3,7,🔄 Moyen
13842.0,2,11,2219.34,5,5,5,15,🏆 VIP
13843.0,17,1,319.75,4,1,2,7,🔄 Moyen
13846.0,35,1,442.73,4,1,2,7,🔄 Moyen
13847.0,355,1,310.72,1,1,2,4,⚠️ À réactiver
13848.0,2,6,2080.0,5,4,5,14,🏆 VIP
13849.0,33,4,1905.85,4,3,4,11,⭐ Fidèle
13851.0,15,6,1865.3,5,4,4,13,🏆 VIP
13852.0,242,2,170.45000000000002,1,2,1,4,⚠️ À réactiver
13854.0,1,17,4133.19,5,5,5,15,🏆 VIP
13855.0,136,5,1253.94,2,4,4,10,⭐ Fidèle
13856.0,99,10,695.48,2,5,3,10,⭐ Fidèle
13857.0,29,7,997.11,4,4,4,12,⭐ Fidèle
13859.0,165,1,314.7,2,1,2,5,⚠️ À réactiver
13861.0,65,3,251.31,3,3,2,8,🔄 Moyen
13862.0,25,1,346.72999999999996,4,1,2,7,🔄 Moyen
13863.0,84,4,918.07,2,3,3,8,🔄 Moyen
13864.0,22,1,662.4,4,1,3,8,🔄 Moyen
13869.0,17,6,5006.62,4,4,5,13,🏆 VIP
13870.0,16,8,2938.59,4,5,5,14,🏆 VIP
13871.0,60,7,1415.15,3,4,4,11,⭐ Fidèle
13872.0,149,6,891.32,2,4,3,9,🔄 Moyen
13873.0,19,5,649.32,4,4,3,11,⭐ Fidèle
13874.0,140,9,1448.75,2,5,4,11,⭐ Fidèle
13875.0,23,9,3027.58,4,5,5,14,🏆 VIP
13877.0,100,4,329.09,2,3,2,7,🔄 Moyen
13878.0,183,3,1191.53,1,3,4,8,🔄 Moyen
13879.0,281,1,395.5,1,1,2,4,⚠️ À réactiver
13880.0,3,5,1171.8899999999999,5,4,4,13,🏆 VIP
13881.0,11,29,27402.98,5,5,5,15,🏆 VIP
13883.0,16,17,3803.99,4,5,5,14,🏆 VIP
13884.0,12,8,1071.08,5,5,4,14,🏆 VIP
13888.0,40,5,1563.42,3,4,4,11,⭐ Fidèle
13889.0,18,7,1438.83,4,4,4,12,⭐ Fidèle
13890.0,10,8,997.87,5,5,4,14,🏆 VIP
13891.0,14,3,863.56,5,3,3,11,⭐ Fidèle
13892.0,113,2,634.68,2,2,3,7,🔄 Moyen
13895.0,142,3,1335.5,2,3,4,9,🔄 Moyen
13896.0,261,1,388.55,1,1,2,4,⚠️ À réactiver
13897.0,74,2,849.56,2,2,3,7,🔄 Moyen
13898.0,47,1,530.47,3,1,3,7,🔄 Moyen
13900.0,16,4,867.14,4,3,3,10,⭐ Fidèle
13901.0,10,15,2732.14,5,5,5,15,🏆 VIP
13902.0,268,8,30411.26,1,5,5,11,⭐ Fidèle
13903.0,36,1,165.45000000000002,3,1,1,5,⚠️ À réactiver
13905.0,207,3,244.45,1,3,2,6,⚠️ À réactiver
13906.0,45,1,42.0,3,1,1,5,⚠️ À réactiver
13907.0,327,1,136.79999999999998,1,1,1,3,⚠️ À réactiver
13909.0,59,2,286.6,3,2,2,7,🔄 Moyen
13910.0,79,1,-127.66,2,1,1,4,⚠️ À réactiver
13911.0,15,13,1619.1299999999999,5,5,4,14,🏆 VIP
13912.0,59,1,124.95,3,1,1,5,⚠️ À réactiver
13913.0,142,1,42.22,2,1,1,4,⚠️ À réactiver
13915.0,30,2,31.2,4,2,1,7,🔄 Moyen
13916.0,99,5,1260.51,2,4,4,10,⭐ Fidèle
13919.0,60,2,975.87,3,2,4,9,🔄 Moyen
13920.0,67,5,1734.8799999999999,3,4,4,11,⭐ Fidèle
13921.0,35,5,720.75,4,4,3,11,⭐ Fidèle
13922.0,53,4,652.45,3,3,3,9,🔄 Moyen
13927.0,49,2,340.97,3,2,2,7,🔄 Moyen
13929.0,52,11,2515.25,3,5,5,13,🏆 VIP
13931.0,28,9,4019.85,4,5,5,14,🏆 VIP
13935.0,232,3,6116.92,1,3,5,9,🔄 Moyen
13936.0,18,2,563.08,4,2,3,9,🔄 Moyen
13937.0,32,2,708.53,4,2,3,9,🔄 Moyen
13939.0,64,6,976.91,3,4,4,11,⭐ Fidèle
13941.0,7,12,5933.74,5,5,5,15,🏆 VIP
13942.0,170,1,320.0,2,1,2,5,⚠️ À réactiver
13943.0,213,1,246.54,1,1,2,4,⚠️ À réactiver
13944.0,289,1,200.43,1,1,1,3,⚠️ À réactiver
13945.0,30,2,854.15,4,2,3,9,🔄 Moyen
13946.0,12,4,1183.86,5,3,4,12,⭐ Fidèle
13948.0,47,4,434.86,3,3,2,8,🔄 Moyen
13952.0,10,14,9544.8,5,5,5,15,🏆 VIP
13953.0,45,5,3125.0,3,4,5,12,⭐ Fidèle
13955.0,11,1,222.21,5,1,1,7,🔄 Moyen
13957.0,53,3,458.25,3,3,2,8,🔄 Moyen
13958.0,8,12,4504.78,5,5,5,15,🏆 VIP
13959.0,35,3,477.98,4,3,3,10,⭐ Fidèle
13961.0,21,2,498.7,4,2,3,9,🔄 Moyen
13962.0,71,1,193.25,2,1,1,4,⚠️ À réactiver
13963.0,3,15,2235.08,5,5,5,15,🏆 VIP
13964.0,23,3,421.9,4,3,2,9,🔄 Moyen
13965.0,91,5,777.66,2,4,3,9,🔄 Moyen
13966.0,71,1,390.85999999999996,2,1,2,5,⚠️ À réactiver
13967.0,32,1,85.6,4,1,1,6,⚠️ À réactiver
13968.0,59,1,123.66,3,1,1,5,⚠️ À réactiver
13969.0,1,20,4226.08,5,5,5,15,🏆 VIP
13970.0,22,2,846.55,4,2,3,9,🔄 Moyen
13971.0,53,7,1891.61,3,4,4,11,⭐ Fidèle
13974.0,213,3,249.93,1,3,2,6,⚠️ À réactiver
13975.0,29,7,2824.06,4,4,5,13,🏆 VIP
13976.0,142,3,834.38,2,3,3,8,🔄 Moyen
13977.0,47,1,519.81,3,1,3,7,🔄 Moyen
13979.0,29,10,2456.96,4,5,5,14,🏆 VIP
13980.0,73,8,552.98,2,5,3,10,⭐ Fidèle
13981.0,36,2,327.39,3,2,2,7,🔄 Moyen
13982.0,1,9,2557.68,5,5,5,15,🏆 VIP
13983.0,2,18,4402.95,5,5,5,15,🏆 VIP
13984.0,2,8,1128.09,5,5,4,14,🏆 VIP
13985.0,10,8,2957.78,5,5,5,15,🏆 VIP
13987.0,15,2,682.54,5,2,3,10,⭐ Fidèle
13988.0,19,2,609.84,4,2,3,9,🔄 Moyen
13989.0,100,3,759.98,2,3,3,8,🔄 Moyen
13992.0,16,2,142.7,4,2,1,7,🔄 Moyen
13993.0,15,12,3280.7,5,5,5,15,🏆 VIP
13995.0,15,12,2452.77,5,5,5,15,🏆 VIP
13996.0,22,2,895.76,4,2,3,9,🔄 Moyen
13997.0,155,3,382.31,2,3,2,7,🔄 Moyen
13998.0,82,3,566.7,2,3,3,8,🔄 Moyen
13999.0,10,21,5572.75,5,5,5,15,🏆 VIP
14000.0,50,6,1243.88,3,4,4,11,⭐ Fidèle
14001.0,9,7,2487.01,5,4,5,14,🏆 VIP
14003.0,368,1,209.41,1,1,1,3,⚠️ À réactiver
14004.0,29,4,1675.81,4,3,4,11,⭐ Fidèle
14006.0,164,4,1234.48,2,4,4,10,⭐ Fidèle
14007.0,148,1,79.48,2,1,1,4,⚠️ À réactiver
14008.0,11,2,493.74,5,2,3,10,⭐ Fidèle
14009.0,98,1,404.3,2,1,2,5,⚠️ À réactiver
14010.0,201,3,288.1,1,3,2,6,⚠️ À réactiver
14011.0,116,3,451.92,2,3,2,7,🔄 Moyen
14013.0,16,3,533.2,4,3,3,10,⭐ Fidèle
14014.0,12,2,1443.03,5,2,4,11,⭐ Fidèle
14016.0,32,8,7051.25,4,5,5,14,🏆 VIP
14017.0,207,1,229.75,1,1,1,3,⚠️ À réactiver
14018.0,281,1,367.15,1,1,2,4,⚠️ À réactiver
14020.0,112,3,570.46,2,3,3,8,🔄 Moyen
14021.0,10,4,1084.68,5,4,4,13,🏆 VIP
14022.0,122,1,352.15,2,1,2,5,⚠️ À réactiver
14024.0,26,1,318.04,4,1,2,7,🔄 Moyen
14025.0,100,10,3969.1,2,5,5,12,⭐ Fidèle
14026.0,106,2,713.11,2,2,3,7,🔄 Moyen
14028.0,134,5,3175.5,2,4,5,11,⭐ Fidèle
14030.0,2,16,5785.5,5,5,5,15,🏆 VIP
14031.0,1,35,23391.329999999998,5,5,5,15,🏆 VIP
14032.0,2,8,1856.23,5,5,4,14,🏆 VIP
14033.0,191,1,109.44,1,1,1,3,⚠️ À réactiver
14035.0,42,6,1424.45,3,4,4,11,⭐ Fidèle
14037.0,114,5,608.75,2,4,3,9,🔄 Moyen
14038.0,24,4,1446.45,4,4,4,12,⭐ Fidèle
14039.0,211,1,115.08,1,1,1,3,⚠️ À réactiver
14040.0,22,27,8915.65,4,5,5,14,🏆 VIP
14042.0,361,1,431.98,1,1,2,4,⚠️ À réactiver
14043.0,127,3,301.3,2,3,2,7,🔄 Moyen
14044.0,54,7,2453.33,3,4,5,12,⭐ Fidèle
14045.0,9,16,8000.88,5,5,5,15,🏆 VIP
14047.0,1,14,2868.72,5,5,5,15,🏆 VIP
14048.0,18,2,338.76,4,2,2,8,🔄 Moyen
14049.0,23,12,7424.88,4,5,5,14,🏆 VIP
14051.0,2,17,6627.16,5,5,5,15,🏆 VIP
14052.0,26,1,255.45,4,1,2,7,🔄 Moyen
14053.0,33,2,312.05,4,2,2,8,🔄 Moyen
14055.0,213,2,795.3199999999999,1,2,3,6,⚠️ À réactiver
14057.0,17,5,2190.88,4,4,5,13,🏆 VIP
14058.0,98,2,469.19,2,2,2,6,⚠️ À réactiver
14060.0,2,14,3367.7599999999998,5,5,5,15,🏆 VIP
14061.0,143,3,917.4300000000001,2,3,3,8,🔄 Moyen
14062.0,10,15,14969.98,5,5,5,15,🏆 VIP
14063.0,66,13,-3767.1999999999994,3,5,1,9,🔄 Moyen
14064.0,66,14,1851.43,3,5,4,12,⭐ Fidèle
14065.0,25,4,889.37,4,4,3,11,⭐ Fidèle
14068.0,232,4,1239.12,1,4,4,9,🔄 Moyen
14069.0,150,2,230.06,2,2,1,5,⚠️ À réactiver
14070.0,320,1,326.55,1,1,2,4,⚠️ À réactiver
14072.0,302,1,390.85,1,1,2,4,⚠️ À réactiver
14074.0,259,1,219.4,1,1,1,3,⚠️ À réactiver
14075.0,39,3,792.61,3,3,3,9,🔄 Moyen
14077.0,31,1,115.66,4,1,1,6,⚠️ À réactiver
14078.0,9,4,643.26,5,4,3,12,⭐ Fidèle
14079.0,318,1,243.63,1,1,2,4,⚠️ À réactiver
14080.0,49,5,1030.13,3,4,4,11,⭐ Fidèle
14081.0,5,13,4345.38,5,5,5,15,🏆 VIP
14082.0,28,1,231.11,4,1,2,7,🔄 Moyen
14083.0,7,3,388.83,5,3,2,10,⭐ Fidèle
14084.0,148,1,150.5,2,1,1,4,⚠️ À réactiver
14085.0,4,16,5656.43,5,5,5,15,🏆 VIP
14086.0,98,1,39.95,2,1,1,4,⚠️ À réactiver
14087.0,40,3,621.8,3,3,3,9,🔄 Moyen
14088.0,23,6,11984.53,4,4,5,13,🏆 VIP
14091.0,290,2,9530.08,1,2,5,8,🔄 Moyen
14092.0,8,11,3146.64,5,5,5,15,🏆 VIP
14094.0,75,2,334.27,2,2,2,6,⚠️ À réactiver
14095.0,358,1,2.95,1,1,1,3,⚠️ À réactiver
14097.0,117,2,422.86,2,2,2,6,⚠️ À réactiver
14099.0,11,10,2607.54,5,5,5,15,🏆 VIP
14101.0,24,8,3965.34,4,5,5,14,🏆 VIP
14103.0,301,1,0.0,1,1,1,3,⚠️ À réactiver
14104.0,25,3,555.37,4,3,3,10,⭐ Fidèle
14105.0,30,7,4443.65,4,4,5,13,🏆 VIP
14106.0,373,1,214.8,1,1,1,3,⚠️ À réactiver
14107.0,73,5,2165.22,2,4,5,11,⭐ Fidèle
14108.0,367,2,447.05,1,2,2,5,⚠️ À réactiver
14110.0,71,22,7287.95,2,5,5,12,⭐ Fidèle
14112.0,87,15,2750.34,2,5,5,12,⭐ Fidèle
14113.0,11,23,4778.83,5,5,5,15,🏆 VIP
14114.0,31,5,977.56,4,4,4,12,⭐ Fidèle
14115.0,137,2,622.67,2,2,3,7,🔄 Moyen
14118.0,64,1,458.45,3,1,2,6,⚠️ À réactiver
14119.0,11,2,183.37,5,2,1,8,🔄 Moyen
14120.0,66,1,-23.8,3,1,1,5,⚠️ À réactiver
14122.0,30,5,309.77,4,4,2,10,⭐ Fidèle
14123.0,369,1,436.18,1,1,2,4,⚠️ À réactiver
14126.0,80,1,466.33,2,1,2,5,⚠️ À réactiver
14127.0,16,3,1190.37,4,3,4,11,⭐ Fidèle
14128.0,179,2,271.86,1,2,2,5,⚠️ À réactiver
14129.0,35,4,1467.48,4,4,4,12,⭐ Fidèle
14130.0,11,3,1398.81,5,3,4,12,⭐ Fidèle
14131.0,284,1,187.87,1,1,1,3,⚠️ À réactiver
14133.0,369,1,305.5,1,1,2,4,⚠️ À réactiver
14134.0,18,15,11123.35,4,5,5,14,🏆 VIP
14135.0,3,12,4914.74,5,5,5,15,🏆 VIP
14136.0,36,7,1553.96,3,4,4,11,⭐ Fidèle
14137.0,317,2,294.09999999999997,1,2,2,5,⚠️ À réactiver
14139.0,126,3,670.98,2,3,3,8,🔄 Moyen
14142.0,9,4,655.9399999999999,5,4,3,12,⭐ Fidèle
14144.0,122,1,30.6,2,1,1,4,⚠️ À réactiver
14145.0,95,3,3857.85,2,3,5,10,⭐ Fidèle
14146.0,19,7,5259.3,4,4,5,13,🏆 VIP
14147.0,24,9,1550.9,4,5,4,13,🏆 VIP
14148.0,50,1,309.09,3,1,2,6,⚠️ À réactiver
14151.0,309,3,666.7,1,3,3,7,🔄 Moyen
14152.0,23,6,1364.35,4,4,4,12,⭐ Fidèle
14153.0,119,1,233.39999999999998,2,1,2,5,⚠️ À réactiver
14154.0,17,8,4917.98,4,5,5,14,🏆 VIP
14156.0,7,138,183180.55,5,5,5,15,🏆 VIP
14157.0,25,3,569.9,4,3,3,10,⭐ Fidèle
14159.0,15,11,2893.58,5,5,5,15,🏆 VIP
14160.0,246,7,8421.47,1,4,5,10,⭐ Fidèle
14161.0,5,5,2208.36,5,4,5,14,🏆 VIP
14163.0,98,1,148.71,2,1,1,4,⚠️ À réactiver
14166.0,141,2,256.85,2,2,2,6,⚠️ À réactiver
14167.0,100,4,721.65,2,4,3,9,🔄 Moyen
14168.0,56,3,305.9,3,3,2,8,🔄 Moyen
14169.0,66,2,624.43,3,2,3,8,🔄 Moyen
14170.0,11,3,597.33,5,3,3,11,⭐ Fidèle
14171.0,366,1,135.0,1,1,1,3,⚠️ À réactiver
14172.0,241,4,389.96999999999997,1,4,2,7,🔄 Moyen
14173.0,277,3,116.11,1,3,1,5,⚠️ À réactiver
14175.0,16,10,4242.38,4,5,5,14,🏆 VIP
14176.0,3,2,339.11,5,2,2,9,🔄 Moyen
14177.0,17,9,1669.93,4,5,4,13,🏆 VIP
14180.0,8,12,1469.98,5,5,4,14,🏆 VIP
14181.0,46,2,310.55,3,2,2,7,🔄 Moyen
14182.0,79,5,660.07,2,4,3,9,🔄 Moyen
14183.0,47,2,286.29,3,2,2,7,🔄 Moyen
14186.0,63,5,1550.6299999999999,3,4,4,11,⭐ Fidèle
14187.0,109,1,123.5,2,1,1,4,⚠️ À réactiver
14189.0,4,2,1160.31,5,2,4,11,⭐ Fidèle
14190.0,302,1,79.9,1,1,1,3,⚠️ À réactiver
14191.0,30,3,53.4,4,3,1,8,🔄 Moyen
14192.0,24,1,293.74,4,1,2,7,🔄 Moyen
14193.0,32,1,356.8,4,1,2,7,🔄 Moyen
14194.0,28,22,7226.12,4,5,5,14,🏆 VIP
14195.0,71,7,1418.54,2,4,4,10,⭐ Fidèle
14197.0,46,1,390.05,3,1,2,6,⚠️ À réactiver
14198.0,36,6,864.08,3,4,3,10,⭐ Fidèle
14199.0,36,5,731.1,3,4,3,10,⭐ Fidèle
14200.0,253,1,379.2,1,1,2,4,⚠️ À réactiver
14201.0,45,3,446.1,3,3,2,8,🔄 Moyen
14202.0,17,3,847.76,4,3,3,10,⭐ Fidèle
14203.0,33,1,339.34,4,1,2,7,🔄 Moyen
14204.0,58,3,901.9300000000001,3,3,3,9,🔄 Moyen
14205.0,1,9,1689.6,5,5,4,14,🏆 VIP
14206.0,16,3,836.95,4,3,3,10,⭐ Fidèle
14207.0,323,1,157.8,1,1,1,3,⚠️ À réactiver
14208.0,187,1,415.31,1,1,2,4,⚠️ À réactiver
14209.0,21,12,2870.24,4,5,5,14,🏆 VIP
14210.0,7,15,3913.43,5,5,5,15,🏆 VIP
14211.0,47,13,2093.39,3,5,5,13,🏆 VIP
14212.0,81,1,1119.66,2,1,4,7,🔄 Moyen
14213.0,7,2,0.0,5,2,1,8,🔄 Moyen
14215.0,4,4,1626.61,5,4,4,13,🏆 VIP
14216.0,45,2,303.09000000000003,3,2,2,7,🔄 Moyen
14217.0,1,11,1281.51,5,5,4,14,🏆 VIP
14219.0,45,2,543.89,3,2,3,8,🔄 Moyen
14220.0,203,2,882.6,1,2,3,6,⚠️ À réactiver
14221.0,85,9,3078.74,2,5,5,12,⭐ Fidèle
14224.0,26,5,847.78,4,4,3,11,⭐ Fidèle
14225.0,70,5,2015.12,3,4,4,11,⭐ Fidèle
14226.0,71,2,766.14,2,2,3,7,🔄 Moyen
14227.0,50,7,3011.6,3,4,5,12,⭐ Fidèle
14228.0,73,3,745.5,2,3,3,8,🔄 Moyen
14229.0,39,6,1018.39,3,4,4,11,⭐ Fidèle
14230.0,71,3,979.8,2,3,4,9,🔄 Moyen
14231.0,86,1,309.90999999999997,2,1,2,5,⚠️ À réactiver
14233.0,10,5,1319.45,5,4,4,13,🏆 VIP
14235.0,134,4,1573.13,2,4,4,10,⭐ Fidèle
14236.0,8,6,1241.88,5,4,4,13,🏆 VIP
14237.0,9,3,466.03999999999996,5,3,2,10,⭐ Fidèle
14238.0,298,2,287.38,1,2,2,5,⚠️ À réactiver
14239.0,67,11,1880.22,3,5,4,12,⭐ Fidèle
14240.0,59,1,357.15,3,1,2,6,⚠️ À réactiver
14241.0,332,1,120.0,1,1,1,3,⚠️ À réactiver
14243.0,1,10,4829.48,5,5,5,15,🏆 VIP
14244.0,295,2,354.82,1,2,2,5,⚠️ À réactiver
14247.0,40,5,632.94,3,4,3,10,⭐ Fidèle
14248.0,95,2,730.37,2,2,3,7,🔄 Moyen
14249.0,46,12,5625.46,3,5,5,13,🏆 VIP
14252.0,17,1,350.99,4,1,2,7,🔄 Moyen
14253.0,129,2,363.40000000000003,2,2,2,6,⚠️ À réactiver
14254.0,68,1,601.03,3,1,3,7,🔄 Moyen
14255.0,182,4,-1441.6,1,4,1,6,⚠️ À réactiver
14256.0,127,6,1462.28,2,4,4,10,⭐ Fidèle
14257.0,16,4,2854.73,4,4,5,13,🏆 VIP
14258.0,24,22,18377.27,4,5,5,14,🏆 VIP
14260.0,107,3,824.28,2,3,3,8,🔄 Moyen
14263.0,59,1,322.93,3,1,2,6,⚠️ À réactiver
14264.0,8,6,1141.89,5,4,4,13,🏆 VIP
14265.0,100,2,843.17,2,2,3,7,🔄 Moyen
14266.0,64,1,40.56,3,1,1,5,⚠️ À réactiver
14267.0,337,2,-19.9,1,2,1,4,⚠️ À réactiver
14268.0,106,1,354.85,2,1,2,5,⚠️ À réactiver
14269.0,71,2,261.68,2,2,2,6,⚠️ À réactiver
14271.0,45,1,106.81,3,1,1,5,⚠️ À réactiver
14272.0,198,2,482.85,1,2,3,6,⚠️ À réactiver
14274.0,322,1,256.6,1,1,2,4,⚠️ À réactiver
14275.0,31,6,1189.3799999999999,4,4,4,12,⭐ Fidèle
14276.0,36,8,909.93,3,5,3,11,⭐ Fidèle
14277.0,47,10,367.4699999999997,3,5,2,10,⭐ Fidèle
14278.0,45,1,205.82999999999998,3,1,1,5,⚠️ À réactiver
14279.0,156,2,191.86,2,2,1,5,⚠️ À réactiver
14281.0,44,1,245.14999999999998,3,1,2,6,⚠️ À réactiver
14282.0,3,12,4115.32,5,5,5,15,🏆 VIP
14283.0,99,4,628.44,2,4,3,9,🔄 Moyen
14284.0,289,1,704.4,1,1,3,5,⚠️ À réactiver
14285.0,149,5,1248.63,2,4,4,10,⭐ Fidèle
14286.0,35,7,3800.89,4,4,5,13,🏆 VIP
14290.0,49,8,1901.48,3,5,4,12,⭐ Fidèle
14291.0,16,13,3971.1,4,5,5,14,🏆 VIP
14292.0,38,13,4068.5699999999997,3,5,5,13,🏆 VIP
14293.0,4,7,2127.77,5,4,5,14,🏆 VIP
14294.0,43,1,375.34,3,1,2,6,⚠️ À réactiver
14295.0,74,6,2161.36,2,4,5,11,⭐ Fidèle
14296.0,49,3,448.45,3,3,2,8,🔄 Moyen
14298.0,11,39,39626.87,5,5,5,15,🏆 VIP
14299.0,1,25,9972.42,5,5,5,15,🏆 VIP
14301.0,45,5,1324.19,3,4,4,11,⭐ Fidèle
14302.0,66,3,742.9,3,3,3,9,🔄 Moyen
14303.0,43,2,277.94,3,2,2,7,🔄 Moyen
14304.0,15,3,1326.71,5,3,4,12,⭐ Fidèle
14306.0,14,4,1058.08,5,4,4,13,🏆 VIP
14307.0,9,6,2067.36,5,4,5,14,🏆 VIP
14308.0,185,5,-849.45,1,4,1,6,⚠️ À réactiver
14309.0,49,2,1428.28,3,2,4,9,🔄 Moyen
14310.0,68,1,492.1,3,1,3,7,🔄 Moyen
14311.0,203,1,206.19,1,1,1,3,⚠️ À réactiver
14312.0,14,5,1478.7,5,4,4,13,🏆 VIP
14313.0,260,1,-302.31,1,1,1,3,⚠️ À réactiver
14314.0,49,2,101.89999999999999,3,2,1,6,⚠️ À réactiver
14315.0,169,3,711.74,2,3,3,8,🔄 Moyen
14316.0,58,6,1355.34,3,4,4,11,⭐ Fidèle
14318.0,96,1,158.02,2,1,1,4,⚠️ À réactiver
14319.0,60,2,476.95,3,2,3,8,🔄 Moyen
14320.0,182,4,861.01,1,4,3,8,🔄 Moyen
14321.0,64,3,667.83,3,3,3,9,🔄 Moyen
14322.0,63,6,384.3,3,4,2,9,🔄 Moyen
14324.0,45,2,701.61,3,2,3,8,🔄 Moyen
14325.0,205,1,245.48,1,1,2,4,⚠️ À réactiver
14326.0,99,2,757.13,2,2,3,7,🔄 Moyen
14327.0,18,5,1583.28,4,4,4,12,⭐ Fidèle
14328.0,66,3,-445.06,3,3,1,7,🔄 Moyen
14329.0,11,14,4806.78,5,5,5,15,🏆 VIP
14330.0,259,1,200.63,1,1,1,3,⚠️ À réactiver
14332.0,17,2,1077.2,4,2,4,10,⭐ Fidèle
14334.0,61,5,1753.52,3,4,4,11,⭐ Fidèle
14337.0,367,1,-658.63,1,1,1,3,⚠️ À réactiver
14338.0,172,1,339.88,2,1,2,5,⚠️ À réactiver
14339.0,64,1,310.75,3,1,2,6,⚠️ À réactiver
14341.0,56,11,2277.09,3,5,5,13,🏆 VIP
14342.0,68,3,235.03,3,3,2,8,🔄 Moyen
14343.0,57,4,1088.91,3,4,4,11,⭐ Fidèle
14344.0,3,14,2443.77,5,5,5,15,🏆 VIP
14346.0,61,3,1294.17,3,3,4,10,⭐ Fidèle
14347.0,372,1,82.6,1,1,1,3,⚠️ À réactiver
14350.0,16,2,689.1,4,2,3,9,🔄 Moyen
14353.0,46,2,285.9,3,2,2,7,🔄 Moyen
14355.0,1,3,840.05,5,3,3,11,⭐ Fidèle
14358.0,25,3,384.3,4,3,2,9,🔄 Moyen
14361.0,214,1,214.71,1,1,1,3,⚠️ À réactiver
14363.0,38,2,227.47,3,2,1,6,⚠️ À réactiver
14365.0,30,2,634.68,4,2,3,9,🔄 Moyen
14366.0,161,1,136.0,2,1,1,4,⚠️ À réactiver
14369.0,278,2,469.13,1,2,2,5,⚠️ À réactiver
14370.0,86,9,1092.1299999999999,2,5,4,11,⭐ Fidèle
14372.0,79,3,830.18,2,3,3,8,🔄 Moyen
14374.0,177,1,108.0,2,1,1,4,⚠️ À réactiver
14375.0,86,2,875.31,2,2,3,7,🔄 Moyen
14376.0,319,1,215.46,1,1,1,3,⚠️ À réactiver
14378.0,257,1,131.25,1,1,1,3,⚠️ À réactiver
14379.0,29,2,920.8100000000001,4,2,3,9,🔄 Moyen
14380.0,239,2,-99.72999999999999,1,2,1,4,⚠️ À réactiver
14381.0,87,1,428.65999999999997,2,1,2,5,⚠️ À réactiver
14382.0,26,2,614.78,4,2,3,9,🔄 Moyen
14384.0,136,1,58.5,2,1,1,4,⚠️ À réactiver
14388.0,2,12,3417.2599999999998,5,5,5,15,🏆 VIP
14389.0,60,6,821.35,3,4,3,10,⭐ Fidèle
14390.0,8,7,1730.86,5,4,4,13,🏆 VIP
14391.0,212,1,135.6,1,1,1,3,⚠️ À réactiver
14392.0,68,1,266.4,3,1,2,6,⚠️ À réactiver
14394.0,200,1,93.8,1,1,1,3,⚠️ À réactiver
14395.0,8,13,4688.9,5,5,5,15,🏆 VIP
14396.0,7,6,1633.94,5,4,4,13,🏆 VIP
14398.0,37,2,707.79,3,2,3,8,🔄 Moyen
14399.0,30,9,2098.16,4,5,5,14,🏆 VIP
14400.0,36,3,1143.3,3,3,4,10,⭐ Fidèle
14401.0,60,11,2663.42,3,5,5,13,🏆 VIP
14402.0,288,1,285.6,1,1,2,4,⚠️ À réactiver
14403.0,219,4,396.45,1,4,2,7,🔄 Moyen
14404.0,5,9,1365.39,5,5,4,14,🏆 VIP
14405.0,22,1,195.0,4,1,1,6,⚠️ À réactiver
14408.0,107,4,1503.24,2,4,4,10,⭐ Fidèle
14409.0,4,6,1545.44,5,4,4,13,🏆 VIP
14410.0,12,2,1546.07,5,2,4,11,⭐ Fidèle
14412.0,60,1,656.16,3,1,3,7,🔄 Moyen
14413.0,46,3,647.67,3,3,3,9,🔄 Moyen
14414.0,10,1,902.35,5,1,3,9,🔄 Moyen
14415.0,15,14,6103.57,5,5,5,15,🏆 VIP
14417.0,23,1,604.2,4,1,3,8,🔄 Moyen
14419.0,18,1,202.85,4,1,1,6,⚠️ À réactiver
14420.0,32,5,1241.85,4,4,4,12,⭐ Fidèle
14421.0,148,5,1643.51,2,4,4,10,⭐ Fidèle
14422.0,10,15,5937.28,5,5,5,15,🏆 VIP
14423.0,60,3,649.76,3,3,3,9,🔄 Moyen
14425.0,63,5,635.89,3,4,3,10,⭐ Fidèle
14426.0,29,11,7185.07,4,5,5,14,🏆 VIP
14427.0,130,2,900.1800000000001,2,2,3,7,🔄 Moyen
14429.0,39,1,516.28,3,1,3,7,🔄 Moyen
14430.0,147,5,956.4,2,4,4,10,⭐ Fidèle
14431.0,15,3,2143.84,5,3,5,13,🏆 VIP
14433.0,101,1,289.6,2,1,2,5,⚠️ À réactiver
14435.0,137,1,90.42,2,1,1,4,⚠️ À réactiver
14436.0,189,1,182.64,1,1,1,3,⚠️ À réactiver
14437.0,1,6,873.34,5,4,3,12,⭐ Fidèle
14439.0,79,4,6781.8,2,4,5,11,⭐ Fidèle
14440.0,1,11,4169.15,5,5,5,15,🏆 VIP
14441.0,1,10,2816.45,5,5,5,15,🏆 VIP
14442.0,50,7,3727.4,3,4,5,12,⭐ Fidèle
14443.0,4,4,950.7,5,4,4,13,🏆 VIP
14444.0,92,1,132.04,2,1,1,4,⚠️ À réactiver
14445.0,91,1,221.65,2,1,1,4,⚠️ À réactiver
14446.0,22,1,201.73,4,1,1,6,⚠️ À réactiver
14447.0,36,1,548.5,3,1,3,7,🔄 Moyen
14449.0,8,5,1575.7,5,4,4,13,🏆 VIP
14450.0,15,4,645.19,5,4,3,12,⭐ Fidèle
14451.0,25,16,2603.0,4,5,5,14,🏆 VIP
14452.0,31,2,401.15,4,2,2,8,🔄 Moyen
14454.0,12,6,970.7,5,4,4,13,🏆 VIP
14455.0,68,5,594.86,3,4,3,10,⭐ Fidèle
14458.0,16,1,237.42,4,1,2,7,🔄 Moyen
14459.0,169,2,3501.22,2,2,5,9,🔄 Moyen
14460.0,32,8,536.26,4,5,3,12,⭐ Fidèle
14461.0,18,11,4594.54,4,5,5,14,🏆 VIP
14462.0,68,1,265.99,3,1,2,6,⚠️ À réactiver
14463.0,135,1,256.95,2,1,2,5,⚠️ À réactiver
14464.0,204,2,111.0,1,2,1,4,⚠️ À réactiver
14465.0,64,8,2887.41,3,5,5,13,🏆 VIP
14466.0,8,7,2374.5,5,4,5,14,🏆 VIP
14467.0,25,8,1622.23,4,5,4,13,🏆 VIP
14468.0,369,1,204.24,1,1,1,3,⚠️ À réactiver
14469.0,52,4,2112.21,3,4,5,12,⭐ Fidèle
14470.0,66,1,250.85,3,1,2,6,⚠️ À réactiver
14471.0,227,2,400.95,1,2,2,5,⚠️ À réactiver
14472.0,325,1,291.38,1,1,2,4,⚠️ À réactiver
14474.0,215,1,730.42,1,1,3,5,⚠️ À réactiver
14475.0,44,1,225.3,3,1,1,5,⚠️ À réactiver
14477.0,72,5,652.8,2,4,3,9,🔄 Moyen
14478.0,18,4,1276.66,4,4,4,12,⭐ Fidèle
14479.0,1,3,982.86,5,3,4,12,⭐ Fidèle
14480.0,38,4,1016.22,3,4,4,11,⭐ Fidèle
14481.0,43,4,1298.81,3,4,4,11,⭐ Fidèle
14482.0,15,8,2124.1,5,5,5,15,🏆 VIP
14483.0,372,1,120.0,1,1,1,3,⚠️ À réactiver
14484.0,37,3,749.06,3,3,3,9,🔄 Moyen
14486.0,147,2,175.5,2,2,1,5,⚠️ À réactiver
14487.0,4,3,244.53,5,3,2,10,⭐ Fidèle
14489.0,73,3,1111.55,2,3,4,9,🔄 Moyen
14490.0,42,2,1273.47,3,2,4,9,🔄 Moyen
14491.0,8,1,127.2,5,1,1,7,🔄 Moyen
14492.0,66,10,1574.3600000000001,3,5,4,12,⭐ Fidèle
14493.0,26,7,2673.21,4,4,5,13,🏆 VIP
14494.0,37,2,261.9,3,2,2,7,🔄 Moyen
14495.0,283,2,42.5,1,2,1,4,⚠️ À réactiver
14496.0,9,9,2107.07,5,5,5,15,🏆 VIP
14497.0,309,1,221.69,1,1,1,3,⚠️ À réactiver
14498.0,37,5,1953.95,3,4,4,11,⭐ Fidèle
14499.0,10,7,1305.3,5,4,4,13,🏆 VIP
14505.0,40,16,5900.1,3,5,5,13,🏆 VIP
14506.0,5,3,1278.5,5,3,4,12,⭐ Fidèle
14507.0,10,7,1804.31,5,4,4,13,🏆 VIP
14508.0,12,4,579.67,5,4,3,12,⭐ Fidèle
14509.0,170,1,110.95,2,1,1,4,⚠️ À réactiver
14510.0,11,4,991.98,5,4,4,13,🏆 VIP
14512.0,19,5,948.19,4,4,4,12,⭐ Fidèle
14513.0,72,3,332.42,2,3,2,7,🔄 Moyen
14514.0,72,7,3539.38,2,4,5,11,⭐ Fidèle
14515.0,23,9,1616.81,4,5,4,13,🏆 VIP
14516.0,152,1,163.92,2,1,1,4,⚠️ À réactiver
14519.0,319,2,206.09,1,2,1,4,⚠️ À réactiver
14521.0,113,2,167.65,2,2,1,5,⚠️ À réactiver
14522.0,231,4,784.08,1,4,3,8,🔄 Moyen
14524.0,45,4,1066.03,3,4,4,11,⭐ Fidèle
14525.0,64,8,3908.44,3,5,5,13,🏆 VIP
14526.0,25,1,262.4,4,1,2,7,🔄 Moyen
14527.0,1,108,18063.16,5,5,5,15,🏆 VIP
14530.0,32,13,3151.24,4,5,5,14,🏆 VIP
14531.0,115,1,376.34,2,1,2,5,⚠️ À réactiver
14532.0,47,8,2913.58,3,5,5,13,🏆 VIP
14533.0,43,6,1372.5,3,4,4,11,⭐ Fidèle
14534.0,33,13,1711.07,4,5,4,13,🏆 VIP
14535.0,31,7,3031.54,4,4,5,13,🏆 VIP
14537.0,242,2,279.89,1,2,2,5,⚠️ À réactiver
14538.0,166,3,982.59,2,3,4,9,🔄 Moyen
14540.0,15,9,2789.18,5,5,5,15,🏆 VIP
14541.0,52,6,1038.03,3,4,4,11,⭐ Fidèle
14543.0,16,29,9277.84,4,5,5,14,🏆 VIP
14544.0,106,1,957.98,2,1,4,7,🔄 Moyen
14545.0,310,1,349.25,1,1,2,4,⚠️ À réactiver
14546.0,12,11,2514.0099999999998,5,5,5,15,🏆 VIP
14548.0,120,7,1974.69,2,4,4,10,⭐ Fidèle
14549.0,56,3,627.31,3,3,3,9,🔄 Moyen
14550.0,24,2,587.69,4,2,3,9,🔄 Moyen
14551.0,45,7,672.36,3,4,3,10,⭐ Fidèle
14552.0,16,2,346.21,4,2,2,8,🔄 Moyen
14553.0,47,5,956.77,3,4,4,11,⭐ Fidèle
14555.0,17,5,1982.34,4,4,4,12,⭐ Fidèle
14556.0,232,3,835.34,1,3,3,7,🔄 Moyen
14558.0,289,5,614.1,1,4,3,8,🔄 Moyen
14559.0,26,1,75.6,4,1,1,6,⚠️ À réactiver
14560.0,15,22,3876.2599999999998,5,5,5,15,🏆 VIP
14562.0,26,8,1654.63,4,5,4,13,🏆 VIP
14563.0,145,2,679.44,2,2,3,7,🔄 Moyen
14564.0,63,5,2519.32,3,4,5,12,⭐ Fidèle
14565.0,109,1,760.1,2,1,3,6,⚠️ À réactiver
14566.0,53,3,2660.0,3,3,5,11,⭐ Fidèle
14568.0,60,2,909.5,3,2,3,8,🔄 Moyen
14569.0,88,3,371.59000000000003,2,3,2,7,🔄 Moyen
14570.0,79,1,395.69,2,1,2,5,⚠️ À réactiver
14571.0,61,1,161.65,3,1,1,5,⚠️ À réactiver
14572.0,53,5,2769.59,3,4,5,12,⭐ Fidèle
14573.0,8,5,968.0,5,4,4,13,🏆 VIP
14574.0,368,1,143.7,1,1,1,3,⚠️ À réactiver
14575.0,124,1,460.71,2,1,2,5,⚠️ À réactiver
14576.0,8,1,35.4,5,1,1,7,🔄 Moyen
14577.0,30,3,514.54,4,3,3,10,⭐ Fidèle
14579.0,68,1,105.56,3,1,1,5,⚠️ À réactiver
14580.0,154,1,14.85,2,1,1,4,⚠️ À réactiver
14581.0,180,1,295.2,1,1,2,4,⚠️ À réactiver
14583.0,19,3,728.48,4,3,3,10,⭐ Fidèle
14584.0,57,4,705.65,3,4,3,10,⭐ Fidèle
14585.0,18,4,986.22,4,4,4,12,⭐ Fidèle
14588.0,214,1,135.39,1,1,1,3,⚠️ À réactiver
14589.0,7,1,39.75,5,1,1,7,🔄 Moyen
14590.0,60,28,2884.29,3,5,5,13,🏆 VIP
14593.0,33,15,2997.18,4,5,5,14,🏆 VIP
14594.0,9,1,255.0,5,1,2,8,🔄 Moyen
14595.0,89,2,423.84999999999997,2,2,2,6,⚠️ À réactiver
14596.0,262,1,229.47,1,1,1,3,⚠️ À réactiver
14597.0,15,4,1318.39,5,4,4,13,🏆 VIP
14598.0,205,2,0.0,1,2,1,4,⚠️ À réactiver
14599.0,26,2,474.54,4,2,3,9,🔄 Moyen
14600.0,29,1,471.84,4,1,3,8,🔄 Moyen
14602.0,292,1,205.36,1,1,1,3,⚠️ À réactiver
14604.0,269,1,143.85999999999999,1,1,1,3,⚠️ À réactiver
14605.0,10,4,937.16,5,4,3,12,⭐ Fidèle
14606.0,2,135,18380.53,5,5,5,15,🏆 VIP
14607.0,103,10,7404.46,2,5,5,12,⭐ Fidèle
14608.0,15,8,1488.29,5,5,4,14,🏆 VIP
14609.0,24,7,764.64,4,4,3,11,⭐ Fidèle
14610.0,31,2,24.35,4,2,1,7,🔄 Moyen
14611.0,75,3,599.38,2,3,3,8,🔄 Moyen
14612.0,51,1,877.7,3,1,3,7,🔄 Moyen
14613.0,316,1,76.32,1,1,1,3,⚠️ À réactiver
14614.0,22,1,295.13,4,1,2,7,🔄 Moyen
14615.0,30,6,934.26,4,4,3,11,⭐ Fidèle
14616.0,21,2,121.7,4,2,1,7,🔄 Moyen
14617.0,38,2,190.47,3,2,1,6,⚠️ À réactiver
14618.0,2,6,757.08,5,4,3,12,⭐ Fidèle
14619.0,177,1,896.8,2,1,3,6,⚠️ À réactiver
14621.0,142,10,1112.51,2,5,4,11,⭐ Fidèle
14623.0,16,6,1161.48,4,4,4,12,⭐ Fidèle
14624.0,51,4,588.22,3,4,3,10,⭐ Fidèle
14625.0,8,14,3543.05,5,5,5,15,🏆 VIP
14626.0,31,8,2617.7,4,5,5,14,🏆 VIP
14627.0,15,2,428.25,5,2,2,9,🔄 Moyen
14628.0,78,3,1326.04,2,3,4,9,🔄 Moyen
14630.0,120,1,338.65,2,1,2,5,⚠️ À réactiver
14631.0,22,4,1016.19,4,4,4,12,⭐ Fidèle
14634.0,73,7,1971.82,2,4,4,10,⭐ Fidèle
14635.0,89,1,215.22,2,1,1,4,⚠️ À réactiver
14637.0,313,1,106.67999999999999,1,1,1,3,⚠️ À réactiver
14639.0,44,3,1994.47,3,3,4,10,⭐ Fidèle
14640.0,45,8,1421.8799999999999,3,5,4,12,⭐ Fidèle
14643.0,253,3,986.0799999999999,1,3,4,8,🔄 Moyen
14644.0,50,8,1297.01,3,5,4,12,⭐ Fidèle
14645.0,261,2,243.15,1,2,2,5,⚠️ À réactiver
14646.0,10,87,243853.05,5,5,5,15,🏆 VIP
14647.0,159,1,276.75,2,1,2,5,⚠️ À réactiver
14648.0,39,19,4458.21,3,5,5,13,🏆 VIP
14649.0,17,7,2336.87,4,4,5,13,🏆 VIP
14650.0,224,1,62.5,1,1,1,3,⚠️ À réactiver
14651.0,30,7,1379.52,4,4,4,12,⭐ Fidèle
14653.0,149,5,1666.99,2,4,4,10,⭐ Fidèle
14654.0,374,1,246.86,1,1,2,4,⚠️ À réactiver
14655.0,15,7,1899.08,5,4,4,13,🏆 VIP
14656.0,51,3,523.6,3,3,3,9,🔄 Moyen
14657.0,65,2,612.65,3,2,3,8,🔄 Moyen
14662.0,63,3,645.16,3,3,3,9,🔄 Moyen
14663.0,66,2,490.6,3,2,3,8,🔄 Moyen
14665.0,63,2,913.9499999999999,3,2,3,8,🔄 Moyen
14667.0,1,36,12489.39,5,5,5,15,🏆 VIP
14668.0,81,1,111.63,2,1,1,4,⚠️ À réactiver
14669.0,269,4,1973.94,1,4,4,9,🔄 Moyen
14670.0,368,1,190.47,1,1,1,3,⚠️ À réactiver
14671.0,185,2,1127.45,1,2,4,7,🔄 Moyen
14672.0,151,2,347.59,2,2,2,6,⚠️ À réactiver
14673.0,3,3,1674.41,5,3,4,12,⭐ Fidèle
14674.0,145,1,173.66,2,1,1,4,⚠️ À réactiver
14675.0,24,1,462.15,4,1,2,7,🔄 Moyen
14676.0,21,8,5742.25,4,5,5,14,🏆 VIP
14677.0,228,1,184.91,1,1,1,3,⚠️ À réactiver
14678.0,207,2,386.44,1,2,2,5,⚠️ À réactiver
14679.0,7,5,1272.95,5,4,4,13,🏆 VIP
14680.0,7,65,27869.0,5,5,5,15,🏆 VIP
14681.0,23,3,376.2,4,3,2,9,🔄 Moyen
14682.0,64,4,1462.81,3,4,4,11,⭐ Fidèle
14683.0,224,1,146.56,1,1,1,3,⚠️ À réactiver
14684.0,26,1,232.27,4,1,2,7,🔄 Moyen
14685.0,212,13,4324.31,1,5,5,11,⭐ Fidèle
14686.0,50,6,877.88,3,4,3,10,⭐ Fidèle
14687.0,36,2,773.6800000000001,3,2,3,8,🔄 Moyen
14688.0,9,8,2082.7,5,5,5,15,🏆 VIP
14690.0,28,2,422.63,4,2,2,8,🔄 Moyen
14692.0,16,8,1153.54,4,5,4,13,🏆 VIP
14693.0,61,7,966.96,3,4,4,11,⭐ Fidèle
14694.0,253,1,244.31,1,1,2,4,⚠️ À réactiver
14695.0,155,4,1552.57,2,4,4,10,⭐ Fidèle
14696.0,1,3,687.7,5,3,3,11,⭐ Fidèle
14699.0,71,3,593.47,2,3,3,8,🔄 Moyen
14700.0,51,2,880.96,3,2,3,8,🔄 Moyen
14701.0,78,6,2012.72,2,4,4,10,⭐ Fidèle
14702.0,1,15,3445.08,5,5,5,15,🏆 VIP
14704.0,60,2,266.66,3,2,2,7,🔄 Moyen
14706.0,254,1,390.69,1,1,2,4,⚠️ À réactiver
14707.0,71,2,139.2,2,2,1,5,⚠️ À réactiver
14708.0,4,3,1085.91,5,3,4,12,⭐ Fidèle
14709.0,15,13,3955.34,5,5,5,15,🏆 VIP
14710.0,15,9,1316.46,5,5,4,14,🏆 VIP
14712.0,54,1,411.0,3,1,2,6,⚠️ À réactiver
14713.0,1,14,2708.21,5,5,5,15,🏆 VIP
14714.0,36,6,736.21,3,4,3,10,⭐ Fidèle
14715.0,78,4,973.0699999999999,2,4,4,10,⭐ Fidèle
14716.0,80,1,235.77,2,1,2,5,⚠️ À réactiver
14717.0,369,2,72.8,1,2,1,4,⚠️ À réactiver
14718.0,46,1,226.42,3,1,1,5,⚠️ À réactiver
14721.0,15,1,115.77,5,1,1,7,🔄 Moyen
14722.0,113,2,325.45,2,2,2,6,⚠️ À réactiver
14723.0,7,7,934.76,5,4,3,12,⭐ Fidèle
14724.0,226,1,345.25,1,1,2,4,⚠️ À réactiver
14725.0,30,4,546.76,4,4,3,11,⭐ Fidèle
14726.0,290,1,124.75,1,1,1,3,⚠️ À réactiver
14727.0,182,3,22.549999999999997,1,3,1,5,⚠️ À réactiver
14728.0,49,1,190.57999999999998,3,1,1,5,⚠️ À réactiver
14729.0,9,3,593.89,5,3,3,11,⭐ Fidèle
14732.0,28,14,2761.18,4,5,5,14,🏆 VIP
14733.0,3,4,6599.06,5,4,5,14,🏆 VIP
14734.0,52,5,1045.47,3,4,4,11,⭐ Fidèle
14735.0,24,25,6102.02,4,5,5,14,🏆 VIP
14736.0,121,2,401.08,2,2,2,6,⚠️ À réactiver
14737.0,36,1,2389.62,3,1,5,9,🔄 Moyen
14738.0,163,3,473.7,2,3,3,8,🔄 Moyen
14739.0,3,21,8370.47,5,5,5,15,🏆 VIP
14740.0,45,9,2645.65,3,5,5,13,🏆 VIP
14741.0,8,2,497.25,5,2,3,10,⭐ Fidèle
14742.0,71,1,579.85,2,1,3,6,⚠️ À réactiver
14743.0,228,1,50.480000000000004,1,1,1,3,⚠️ À réactiver
14744.0,2,9,2732.49,5,5,5,15,🏆 VIP
14745.0,137,11,1324.3,2,5,4,11,⭐ Fidèle
14746.0,42,4,593.5,3,4,3,10,⭐ Fidèle
14748.0,4,12,1360.46,5,5,4,14,🏆 VIP
14749.0,115,1,310.15,2,1,2,5,⚠️ À réactiver
14750.0,372,1,112.03,1,1,1,3,⚠️ À réactiver
14751.0,320,2,126.44999999999999,1,2,1,4,⚠️ À réactiver
14753.0,96,1,306.36,2,1,2,5,⚠️ À réactiver
14754.0,53,5,908.23,3,4,3,10,⭐ Fidèle
14755.0,17,18,4886.07,4,5,5,14,🏆 VIP
14756.0,10,3,1874.5,5,3,4,12,⭐ Fidèle
14758.0,32,3,1380.91,4,3,4,11,⭐ Fidèle
14761.0,80,1,192.02,2,1,1,4,⚠️ À réactiver
14762.0,262,1,117.05,1,1,1,3,⚠️ À réactiver
14763.0,368,1,-9.95,1,1,1,3,⚠️ À réactiver
14766.0,1,9,4008.91,5,5,5,15,🏆 VIP
14767.0,110,1,382.81,2,1,2,5,⚠️ À réactiver
14769.0,26,11,5055.07,4,5,5,14,🏆 VIP
14770.0,103,7,2748.47,2,4,5,11,⭐ Fidèle
14771.0,241,3,579.92,1,3,3,7,🔄 Moyen
14773.0,224,2,125.7,1,2,1,4,⚠️ À réactiver
14774.0,164,1,241.45,2,1,2,5,⚠️ À réactiver
14775.0,8,1,406.56,5,1,2,8,🔄 Moyen
14776.0,22,6,1143.44,4,4,4,12,⭐ Fidèle
14777.0,36,2,256.71,3,2,2,7,🔄 Moyen
14781.0,56,1,-530.31,3,1,1,5,⚠️ À réactiver
14783.0,291,2,305.35,1,2,2,5,⚠️ À réactiver
14784.0,25,1,159.94,4,1,1,6,⚠️ À réactiver
14786.0,186,1,90.96,1,1,1,3,⚠️ À réactiver
14787.0,107,1,110.64999999999999,2,1,1,4,⚠️ À réactiver
14788.0,232,1,476.88,1,1,3,5,⚠️ À réactiver
14790.0,10,6,1781.56,5,4,4,13,🏆 VIP
14791.0,242,1,303.63,1,1,2,4,⚠️ À réactiver
14793.0,171,1,396.91,2,1,2,5,⚠️ À réactiver
14794.0,29,4,617.04,4,4,3,11,⭐ Fidèle
14796.0,2,14,2851.61,5,5,5,15,🏆 VIP
14797.0,143,1,300.31,2,1,2,5,⚠️ À réactiver
14798.0,17,6,541.37,4,4,3,11,⭐ Fidèle
14799.0,373,1,180.45,1,1,1,3,⚠️ À réactiver
14800.0,5,8,3179.25,5,5,5,15,🏆 VIP
14802.0,66,6,-1502.98,3,4,1,8,🔄 Moyen
14805.0,40,3,549.99,3,3,3,9,🔄 Moyen
14806.0,75,1,110.04,2,1,1,4,⚠️ À réactiver
14807.0,26,2,519.29,4,2,3,9,🔄 Moyen
14809.0,257,2,686.76,1,2,3,6,⚠️ À réactiver
14810.0,5,3,449.14,5,3,2,10,⭐ Fidèle
14811.0,23,1,170.5,4,1,1,6,⚠️ À réactiver
14812.0,234,1,185.8,1,1,1,3,⚠️ À réactiver
14813.0,5,4,935.4399999999999,5,4,3,12,⭐ Fidèle
14814.0,217,1,160.46,1,1,1,3,⚠️ À réactiver
14817.0,16,7,2778.87,4,4,5,13,🏆 VIP
14818.0,94,3,512.61,2,3,3,8,🔄 Moyen
14819.0,130,2,198.09,2,2,1,5,⚠️ À réactiver
14820.0,16,5,767.47,4,4,3,11,⭐ Fidèle
14821.0,2,7,1237.65,5,4,4,13,🏆 VIP
14822.0,121,1,157.7,2,1,1,4,⚠️ À réactiver
14824.0,15,8,2824.8,5,5,5,15,🏆 VIP
14825.0,4,16,2659.37,5,5,5,15,🏆 VIP
14826.0,217,2,385.2,1,2,2,5,⚠️ À réactiver
14827.0,301,1,0.0,1,1,1,3,⚠️ À réactiver
14828.0,24,11,7663.7,4,5,5,14,🏆 VIP
14829.0,8,4,995.29,5,4,4,13,🏆 VIP
14831.0,210,7,1623.97,1,4,4,9,🔄 Moyen
14832.0,266,3,-274.63,1,3,1,5,⚠️ À réactiver
14833.0,134,1,94.8,2,1,1,4,⚠️ À réactiver
14834.0,43,1,485.86,3,1,3,7,🔄 Moyen
14835.0,163,3,293.09999999999997,2,3,2,7,🔄 Moyen
14837.0,73,7,1804.62,2,4,4,10,⭐ Fidèle
14838.0,59,2,773.6700000000001,3,2,3,8,🔄 Moyen
14839.0,54,3,915.28,3,3,3,9,🔄 Moyen
14840.0,163,2,277.36,2,2,2,6,⚠️ À réactiver
14841.0,10,8,3867.24,5,5,5,15,🏆 VIP
14843.0,72,1,211.8,2,1,1,4,⚠️ À réactiver
14844.0,66,8,3498.62,3,5,5,13,🏆 VIP
14845.0,235,1,150.0,1,1,1,3,⚠️ À réactiver
14846.0,59,2,406.8,3,2,2,7,🔄 Moyen
14847.0,36,3,1011.1999999999999,3,3,4,10,⭐ Fidèle
14848.0,40,1,310.56,3,1,2,6,⚠️ À réactiver
14849.0,9,25,7638.16,5,5,5,15,🏆 VIP
14850.0,3,8,1297.06,5,5,4,14,🏆 VIP
14851.0,266,1,318.06,1,1,2,4,⚠️ À réactiver
14852.0,60,15,3286.94,3,5,5,13,🏆 VIP
14853.0,50,4,888.3199999999999,3,4,3,10,⭐ Fidèle
14854.0,26,6,1552.28,4,4,4,12,⭐ Fidèle
14855.0,110,5,5874.65,2,4,5,11,⭐ Fidèle
14857.0,78,7,2413.28,2,4,5,11,⭐ Fidèle
14858.0,141,1,180.75,2,1,1,4,⚠️ À réactiver
14859.0,190,1,351.9,1,1,2,4,⚠️ À réactiver
14861.0,16,13,1192.61,4,5,4,13,🏆 VIP
14864.0,367,1,-48.75,1,1,1,3,⚠️ À réactiver
14865.0,8,3,77.52,5,3,1,9,🔄 Moyen
14866.0,2,8,6460.32,5,5,5,15,🏆 VIP
14867.0,4,16,2200.13,5,5,5,15,🏆 VIP
14868.0,16,4,1230.42,4,4,4,12,⭐ Fidèle
14869.0,16,6,2054.85,4,4,4,12,⭐ Fidèle
14870.0,36,8,1467.35,3,5,4,12,⭐ Fidèle
14871.0,129,5,736.59,2,4,3,9,🔄 Moyen
14872.0,116,4,802.68,2,4,3,9,🔄 Moyen
14873.0,269,1,334.45,1,1,2,4,⚠️ À réactiver
14874.0,171,1,116.18,2,1,1,4,⚠️ À réactiver
14875.0,71,2,1392.83,2,2,4,8,🔄 Moyen
14876.0,157,2,256.7,2,2,2,6,⚠️ À réactiver
14877.0,54,2,437.0,3,2,2,7,🔄 Moyen
14878.0,12,19,2326.68,5,5,5,15,🏆 VIP
14879.0,320,1,185.06,1,1,1,3,⚠️ À réactiver
14882.0,26,13,2836.85,4,5,5,14,🏆 VIP
14884.0,305,1,120.6,1,1,1,3,⚠️ À réactiver
14885.0,63,3,730.8,3,3,3,9,🔄 Moyen
14890.0,254,2,691.6,1,2,3,6,⚠️ À réactiver
14891.0,52,2,552.35,3,2,3,8,🔄 Moyen
14892.0,326,1,202.35,1,1,1,3,⚠️ À réactiver
14893.0,203,4,544.41,1,4,3,8,🔄 Moyen
14894.0,79,4,756.46,2,4,3,9,🔄 Moyen
14895.0,19,24,13468.56,4,5,5,14,🏆 VIP
14896.0,1,9,1504.7,5,5,4,14,🏆 VIP
14897.0,38,5,1734.36,3,4,4,11,⭐ Fidèle
14898.0,1,12,2128.54,5,5,5,15,🏆 VIP
14899.0,31,1,1384.88,4,1,4,9,🔄 Moyen
14900.0,158,1,13.92,2,1,1,4,⚠️ À réactiver
14901.0,2,6,862.06,5,4,3,12,⭐ Fidèle
14902.0,31,3,686.16,4,3,3,10,⭐ Fidèle
14904.0,44,2,615.2,3,2,3,8,🔄 Moyen
14905.0,10,7,1339.79,5,4,4,13,🏆 VIP
14906.0,81,3,-66.98,2,3,1,6,⚠️ À réactiver
14907.0,3,14,2615.84,5,5,5,15,🏆 VIP
14908.0,99,1,104.1,2,1,1,4,⚠️ À réactiver
14909.0,64,5,1380.98,3,4,4,11,⭐ Fidèle
14911.0,1,270,137675.91,5,5,5,15,🏆 VIP
14912.0,19,8,-92.94000000000005,4,5,1,10,⭐ Fidèle
14913.0,24,4,2845.7,4,4,5,13,🏆 VIP
14914.0,241,1,-5.85,1,1,1,3,⚠️ À réactiver
14915.0,11,10,1493.82,5,5,4,14,🏆 VIP
14916.0,67,6,1623.37,3,4,4,11,⭐ Fidèle
14917.0,232,2,1123.75,1,2,4,7,🔄 Moyen
14918.0,40,7,4345.66,3,4,5,12,⭐ Fidèle
14919.0,175,1,359.35,2,1,2,5,⚠️ À réactiver
14920.0,201,1,629.4,1,1,3,5,⚠️ À réactiver
14922.0,29,2,843.74,4,2,3,9,🔄 Moyen
14924.0,246,2,620.96,1,2,3,6,⚠️ À réactiver
14925.0,367,1,-7.95,1,1,1,3,⚠️ À réactiver
14926.0,17,3,337.65,4,3,2,9,🔄 Moyen
14927.0,32,1,308.2,4,1,2,7,🔄 Moyen
14928.0,255,2,204.46,1,2,1,4,⚠️ À réactiver
14929.0,57,1,612.81,3,1,3,7,🔄 Moyen
14930.0,57,6,2763.78,3,4,5,12,⭐ Fidèle
14932.0,1,2,666.13,5,2,3,10,⭐ Fidèle
14933.0,79,5,885.0,2,4,3,9,🔄 Moyen
14934.0,14,6,555.26,5,4,3,12,⭐ Fidèle
14935.0,255,1,1065.1200000000001,1,1,4,6,⚠️ À réactiver
14936.0,26,5,4261.04,4,4,5,13,🏆 VIP
14938.0,138,4,2289.43,2,4,5,11,⭐ Fidèle
14939.0,266,1,-934.66,1,1,1,3,⚠️ À réactiver
14940.0,53,2,531.49,3,2,3,8,🔄 Moyen
14941.0,214,1,182.1,1,1,1,3,⚠️ À réactiver
14942.0,37,5,706.56,3,4,3,10,⭐ Fidèle
14943.0,299,1,107.62,1,1,1,3,⚠️ À réactiver
14944.0,25,10,3831.97,4,5,5,14,🏆 VIP
14945.0,49,1,179.39999999999998,3,1,1,5,⚠️ À réactiver
14947.0,24,4,758.97,4,4,3,11,⭐ Fidèle
14949.0,95,6,498.55,2,4,3,9,🔄 Moyen
14952.0,2,29,9331.46,5,5,5,15,🏆 VIP
14953.0,54,4,715.55,3,4,3,10,⭐ Fidèle
14954.0,339,1,167.27,1,1,1,3,⚠️ À réactiver
14955.0,368,1,163.77,1,1,1,3,⚠️ À réactiver
14956.0,57,1,1325.0,3,1,4,8,🔄 Moyen
14957.0,280,1,274.79999999999995,1,1,2,4,⚠️ À réactiver
14958.0,231,3,458.26,1,3,2,6,⚠️ À réactiver
14961.0,15,16,9322.32,5,5,5,15,🏆 VIP
14962.0,175,3,240.21,2,3,2,7,🔄 Moyen
14963.0,15,8,1670.83,5,5,4,14,🏆 VIP
14966.0,23,5,924.52,4,4,3,11,⭐ Fidèle
14967.0,77,6,1216.72,2,4,4,10,⭐ Fidèle
14968.0,94,1,357.4,2,1,2,5,⚠️ À réactiver
14969.0,339,1,906.23,1,1,3,5,⚠️ À réactiver
14970.0,45,12,2001.3400000000001,3,5,4,12,⭐ Fidèle
14972.0,17,1,30.299999999999997,4,1,1,6,⚠️ À réactiver
14975.0,57,1,192.45,3,1,1,5,⚠️ À réactiver
14977.0,361,1,31.93,1,1,1,3,⚠️ À réactiver
14978.0,66,7,1174.92,3,4,4,11,⭐ Fidèle
14979.0,371,1,439.46000000000004,1,1,2,4,⚠️ À réactiver
14980.0,373,1,150.68,1,1,1,3,⚠️ À réactiver
14981.0,29,2,211.4,4,2,1,7,🔄 Moyen
14982.0,208,1,237.78,1,1,2,4,⚠️ À réactiver
14983.0,325,1,183.2,1,1,1,3,⚠️ À réactiver
14984.0,24,4,1058.1399999999999,4,4,4,12,⭐ Fidèle
14986.0,12,2,566.9,5,2,3,10,⭐ Fidèle
14987.0,1,8,1305.85,5,5,4,14,🏆 VIP
14988.0,16,6,1732.06,4,4,4,12,⭐ Fidèle
14989.0,297,1,342.4,1,1,2,4,⚠️ À réactiver
14990.0,248,2,305.42,1,2,2,5,⚠️ À réactiver
14991.0,66,1,314.67,3,1,2,6,⚠️ À réactiver
14992.0,78,1,210.5,2,1,1,4,⚠️ À réactiver
14993.0,199,1,36.13,1,1,1,3,⚠️ À réactiver
14994.0,18,8,886.33,4,5,3,12,⭐ Fidèle
14996.0,117,2,442.29,2,2,2,6,⚠️ À réactiver
14997.0,291,1,230.4,1,1,1,3,⚠️ À réactiver
14998.0,64,2,340.86,3,2,2,7,🔄 Moyen
14999.0,228,1,129.48,1,1,1,3,⚠️ À réactiver
15001.0,30,2,230.85999999999999,4,2,2,8,🔄 Moyen
15002.0,3,6,3175.52,5,4,5,14,🏆 VIP
15003.0,109,7,1055.7,2,4,4,10,⭐ Fidèle
15005.0,2,42,7582.78,5,5,5,15,🏆 VIP
15006.0,89,1,323.05,2,1,2,5,⚠️ À réactiver
15008.0,116,2,360.0,2,2,2,6,⚠️ À réactiver
15011.0,31,2,416.6,4,2,2,8,🔄 Moyen
15012.0,9,2,437.58,5,2,2,9,🔄 Moyen
15013.0,123,10,1641.3,2,5,4,11,⭐ Fidèle
15015.0,137,20,2275.82,2,5,5,12,⭐ Fidèle
15016.0,29,5,452.26,4,4,2,10,⭐ Fidèle
15018.0,3,1,111.25,5,1,1,7,🔄 Moyen
15020.0,15,1,203.42,5,1,1,7,🔄 Moyen
15021.0,2,7,817.31,5,4,3,12,⭐ Fidèle
15022.0,313,1,281.05,1,1,2,4,⚠️ À réactiver
15023.0,5,12,5329.03,5,5,5,15,🏆 VIP
15024.0,3,8,2414.18,5,5,5,15,🏆 VIP
15025.0,204,1,636.08,1,1,3,5,⚠️ À réactiver
15026.0,11,2,592.61,5,2,3,10,⭐ Fidèle
15027.0,16,7,1922.0900000000001,4,4,4,12,⭐ Fidèle
15028.0,4,3,530.58,5,3,3,11,⭐ Fidèle
15029.0,254,2,362.15,1,2,2,5,⚠️ À réactiver
15030.0,16,7,1446.38,4,4,4,12,⭐ Fidèle
15031.0,30,12,2189.23,4,5,5,14,🏆 VIP
15032.0,2,7,8821.55,5,4,5,14,🏆 VIP
15034.0,22,6,4004.79,4,4,5,13,🏆 VIP
15037.0,12,2,402.51,5,2,2,9,🔄 Moyen
15038.0,5,4,604.37,5,4,3,12,⭐ Fidèle
15039.0,4,56,19956.55,5,5,5,15,🏆 VIP
15040.0,177,1,7.49,2,1,1,4,⚠️ À réactiver
15041.0,80,1,113.67,2,1,1,4,⚠️ À réactiver
15042.0,231,1,179.51999999999998,1,1,1,3,⚠️ À réactiver
15043.0,99,5,2336.8,2,4,5,11,⭐ Fidèle
15044.0,15,25,8212.15,5,5,5,15,🏆 VIP
15046.0,59,12,2519.37,3,5,5,13,🏆 VIP
15048.0,4,1,98.7,5,1,1,7,🔄 Moyen
15050.0,57,2,2411.7,3,2,5,10,⭐ Fidèle
15051.0,15,7,2528.55,5,4,5,14,🏆 VIP
15055.0,110,3,560.07,2,3,3,8,🔄 Moyen
15056.0,156,1,133.45,2,1,1,4,⚠️ À réactiver
15057.0,79,4,1695.06,2,4,4,10,⭐ Fidèle
15058.0,12,6,1252.19,5,4,4,13,🏆 VIP
15059.0,12,16,2101.8,5,5,5,15,🏆 VIP
15061.0,3,90,82162.74,5,5,5,15,🏆 VIP
15062.0,59,4,1597.76,3,4,4,11,⭐ Fidèle
15064.0,46,4,1254.41,3,4,4,11,⭐ Fidèle
15065.0,46,1,168.73,3,1,1,5,⚠️ À réactiver
15067.0,49,3,2120.37,3,3,5,11,⭐ Fidèle
15068.0,54,2,623.49,3,2,3,8,🔄 Moyen
15070.0,8,3,737.05,5,3,3,11,⭐ Fidèle
15071.0,22,2,473.49,4,2,3,9,🔄 Moyen
15072.0,115,1,187.51999999999998,2,1,1,4,⚠️ À réactiver
15073.0,36,5,1744.61,3,4,4,11,⭐ Fidèle
15074.0,65,2,817.46,3,2,3,8,🔄 Moyen
15076.0,128,4,544.99,2,4,3,9,🔄 Moyen
15077.0,92,4,2423.88,2,4,5,11,⭐ Fidèle
15078.0,4,28,7953.17,5,5,5,15,🏆 VIP
15079.0,1,13,2793.09,5,5,5,15,🏆 VIP
15080.0,63,2,546.25,3,2,3,8,🔄 Moyen
15081.0,3,8,1460.92,5,5,4,14,🏆 VIP
15082.0,304,1,93.35,1,1,1,3,⚠️ À réactiver
15084.0,15,2,965.1999999999999,5,2,4,11,⭐ Fidèle
15085.0,365,1,347.54,1,1,2,4,⚠️ À réactiver
15086.0,200,2,218.53,1,2,1,4,⚠️ À réactiver
15091.0,107,4,546.15,2,4,3,9,🔄 Moyen
15092.0,84,2,315.35,2,2,2,6,⚠️ À réactiver
15093.0,8,26,9247.74,5,5,5,15,🏆 VIP
15094.0,99,2,83.0,2,2,1,5,⚠️ À réactiver
15095.0,56,6,1771.04,3,4,4,11,⭐ Fidèle
15097.0,219,4,338.96999999999997,1,4,2,7,🔄 Moyen
15100.0,2,11,1684.3999999999999,5,5,4,14,🏆 VIP
15101.0,71,8,993.46,2,5,4,11,⭐ Fidèle
15102.0,166,2,554.67,2,2,3,7,🔄 Moyen
15105.0,66,2,795.98,3,2,3,8,🔄 Moyen
15107.0,8,5,608.6,5,4,3,12,⭐ Fidèle
15109.0,215,2,498.15,1,2,3,6,⚠️ À réactiver
15110.0,39,2,509.75,3,2,3,8,🔄 Moyen
15111.0,8,3,1163.39,5,3,4,12,⭐ Fidèle
15112.0,247,1,209.4,1,1,1,3,⚠️ À réactiver
15114.0,19,2,639.56,4,2,3,9,🔄 Moyen
15115.0,353,2,187.99,1,2,1,4,⚠️ À réactiver
15117.0,84,3,934.19,2,3,3,8,🔄 Moyen
15122.0,58,10,2849.29,3,5,5,13,🏆 VIP
15123.0,57,3,2456.86,3,3,5,11,⭐ Fidèle
15124.0,112,2,266.63,2,2,2,6,⚠️ À réactiver
15125.0,115,13,5007.28,2,5,5,12,⭐ Fidèle
15126.0,172,2,449.49,2,2,2,6,⚠️ À réactiver
15127.0,155,1,304.97,2,1,2,5,⚠️ À réactiver
15128.0,66,1,312.68,3,1,2,6,⚠️ À réactiver
15129.0,21,12,3412.7799999999997,4,5,5,14,🏆 VIP
15131.0,30,1,80.28,4,1,1,6,⚠️ À réactiver
15133.0,18,2,824.48,4,2,3,9,🔄 Moyen
15134.0,17,2,208.29999999999998,4,2,1,7,🔄 Moyen
15135.0,192,1,166.63,1,1,1,3,⚠️ À réactiver
15137.0,156,5,747.55,2,4,3,9,🔄 Moyen
15138.0,21,2,486.59,4,2,3,9,🔄 Moyen
15140.0,78,1,889.44,2,1,3,6,⚠️ À réactiver
15141.0,93,9,1378.31,2,5,4,11,⭐ Fidèle
15142.0,46,6,2110.23,3,4,5,12,⭐ Fidèle
15143.0,68,1,304.18,3,1,2,6,⚠️ À réactiver
15144.0,15,15,5476.47,5,5,5,15,🏆 VIP
15149.0,212,4,1033.81,1,4,4,9,🔄 Moyen
15150.0,92,3,3686.61,2,3,5,10,⭐ Fidèle
15151.0,59,2,2085.61,3,2,5,10,⭐ Fidèle
15152.0,331,2,513.73,1,2,3,6,⚠️ À réactiver
15154.0,114,2,1091.99,2,2,4,8,🔄 Moyen
15155.0,19,1,383.96999999999997,4,1,2,7,🔄 Moyen
15157.0,205,2,718.04,1,2,3,6,⚠️ À réactiver
15158.0,36,2,36.25999999999999,3,2,1,6,⚠️ À réactiver
15159.0,31,4,3475.72,4,4,5,13,🏆 VIP
15160.0,10,3,431.11,5,3,2,10,⭐ Fidèle
15161.0,24,1,119.92,4,1,1,6,⚠️ À réactiver
15162.0,364,2,241.5,1,2,2,5,⚠️ À réactiver
15164.0,16,7,1208.97,4,4,4,12,⭐ Fidèle
15165.0,9,1,487.75,5,1,3,9,🔄 Moyen
15166.0,103,1,167.16,2,1,1,4,⚠️ À réactiver
15167.0,43,4,1496.67,3,4,4,11,⭐ Fidèle
15169.0,18,2,569.22,4,2,3,9,🔄 Moyen
15170.0,42,1,81.15,3,1,1,5,⚠️ À réactiver
15173.0,16,8,1399.26,4,5,4,13,🏆 VIP
15174.0,46,1,345.71,3,1,2,6,⚠️ À réactiver
15176.0,232,2,985.09,1,2,4,7,🔄 Moyen
15177.0,61,1,948.93,3,1,4,8,🔄 Moyen
15179.0,28,10,5240.62,4,5,5,14,🏆 VIP
15180.0,3,3,816.93,5,3,3,11,⭐ Fidèle
15181.0,1,4,268.17,5,4,2,11,⭐ Fidèle
15182.0,16,12,2319.9,4,5,5,14,🏆 VIP
15183.0,183,4,637.03,1,4,3,8,🔄 Moyen
15184.0,23,2,283.19,4,2,2,8,🔄 Moyen
15186.0,110,3,991.79,2,3,4,9,🔄 Moyen
15188.0,361,1,310.43,1,1,2,4,⚠️ À réactiver
15189.0,17,5,1298.99,4,4,4,12,⭐ Fidèle
15190.0,70,1,834.4399999999999,3,1,3,7,🔄 Moyen
15191.0,99,3,588.05,2,3,3,8,🔄 Moyen
15192.0,1,3,937.0699999999999,5,3,3,11,⭐ Fidèle
15194.0,4,18,4666.51,5,5,5,15,🏆 VIP
15196.0,68,2,316.25,3,2,2,7,🔄 Moyen
15197.0,24,5,771.4,4,4,3,11,⭐ Fidèle
15198.0,43,4,365.81,3,4,2,9,🔄 Moyen
15199.0,10,6,1853.7,5,4,4,13,🏆 VIP
15200.0,130,1,549.05,2,1,3,6,⚠️ À réactiver
15201.0,72,3,598.06,2,3,3,8,🔄 Moyen
15202.0,56,8,-2570.1800000000003,3,5,1,9,🔄 Moyen
15203.0,26,9,2572.38,4,5,5,14,🏆 VIP
15207.0,45,5,653.77,3,4,3,10,⭐ Fidèle
15208.0,59,1,100.4,3,1,1,5,⚠️ À réactiver
15209.0,366,1,178.98,1,1,1,3,⚠️ À réactiver
15210.0,14,2,845.01,5,2,3,10,⭐ Fidèle
15211.0,1,1,383.07,5,1,2,8,🔄 Moyen
15212.0,12,1,106.47999999999999,5,1,1,7,🔄 Moyen
15215.0,29,5,880.47,4,4,3,11,⭐ Fidèle
15216.0,254,1,389.49,1,1,2,4,⚠️ À réactiver
15217.0,199,1,426.24,1,1,2,4,⚠️ À réactiver
15218.0,25,14,5699.11,4,5,5,14,🏆 VIP
15219.0,284,1,379.7,1,1,2,4,⚠️ À réactiver
15221.0,2,7,1702.0,5,4,4,13,🏆 VIP
15222.0,108,16,2830.66,2,5,5,12,⭐ Fidèle
15223.0,245,3,662.2,1,3,3,7,🔄 Moyen
15224.0,148,5,526.78,2,4,3,9,🔄 Moyen
15227.0,32,4,1269.0900000000001,4,4,4,12,⭐ Fidèle
15228.0,64,2,2193.56,3,2,5,10,⭐ Fidèle
15229.0,222,1,160.5,1,1,1,3,⚠️ À réactiver
15231.0,232,2,228.35999999999999,1,2,1,4,⚠️ À réactiver
15233.0,37,1,59.4,3,1,1,5,⚠️ À réactiver
15235.0,5,6,690.3,5,4,3,12,⭐ Fidèle
15240.0,7,14,2629.43,5,5,5,15,🏆 VIP
15241.0,66,3,1293.72,3,3,4,10,⭐ Fidèle
15242.0,58,1,302.03999999999996,3,1,2,6,⚠️ À réactiver
15243.0,71,1,610.6,2,1,3,6,⚠️ À réactiver
15244.0,296,2,218.61,1,2,1,4,⚠️ À réactiver
15245.0,38,5,2095.0,3,4,5,12,⭐ Fidèle
15246.0,191,1,266.25,1,1,2,4,⚠️ À réactiver
15247.0,100,3,611.11,2,3,3,8,🔄 Moyen
15248.0,47,4,1865.03,3,4,4,11,⭐ Fidèle
15249.0,66,6,2489.79,3,4,5,12,⭐ Fidèle
15250.0,276,1,60.0,1,1,1,3,⚠️ À réactiver
15251.0,50,16,9768.49,3,5,5,13,🏆 VIP
15252.0,53,5,1312.28,3,4,4,11,⭐ Fidèle
15253.0,35,6,1117.99,4,4,4,12,⭐ Fidèle
15254.0,182,3,773.04,1,3,3,7,🔄 Moyen
15255.0,32,10,2779.92,4,5,5,14,🏆 VIP
15256.0,197,1,71.95,1,1,1,3,⚠️ À réactiver
15257.0,50,1,368.75,3,1,2,6,⚠️ À réactiver
15259.0,148,4,1182.3799999999999,2,4,4,10,⭐ Fidèle
15260.0,8,24,7317.61,5,5,5,15,🏆 VIP
15261.0,17,3,1253.18,4,3,4,11,⭐ Fidèle
15262.0,16,2,239.87,4,2,2,8,🔄 Moyen
15264.0,115,2,450.46,2,2,2,6,⚠️ À réactiver
15265.0,240,2,1839.52,1,2,4,7,🔄 Moyen
15266.0,15,5,722.4,5,4,3,12,⭐ Fidèle
15268.0,114,4,941.25,2,4,4,10,⭐ Fidèle
15269.0,16,2,816.56,4,2,3,9,🔄 Moyen
15270.0,24,22,4895.79,4,5,5,14,🏆 VIP
15271.0,1,11,2153.47,5,5,5,15,🏆 VIP
15272.0,86,4,1363.54,2,4,4,10,⭐ Fidèle
15273.0,235,1,228.96,1,1,1,3,⚠️ À réactiver
15276.0,30,4,495.71999999999997,4,4,3,11,⭐ Fidèle
15277.0,61,1,220.44,3,1,1,5,⚠️ À réactiver
15278.0,197,4,496.16,1,4,3,8,🔄 Moyen
15279.0,1,6,1264.33,5,4,4,13,🏆 VIP
15280.0,124,2,293.09999999999997,2,2,2,6,⚠️ À réactiver
15281.0,14,10,6077.67,5,5,5,15,🏆 VIP
15282.0,206,1,348.59,1,1,2,4,⚠️ À réactiver
15283.0,26,4,135.43,4,4,1,9,🔄 Moyen
15284.0,136,1,24.75,2,1,1,4,⚠️ À réactiver
15285.0,43,1,94.92,3,1,1,5,⚠️ À réactiver
15287.0,15,3,369.34000000000003,5,3,2,10,⭐ Fidèle
15288.0,1,6,1576.61,5,4,4,13,🏆 VIP
15289.0,57,3,635.61,3,3,3,9,🔄 Moyen
15290.0,29,9,2551.81,4,5,5,14,🏆 VIP
15291.0,9,34,8854.73,5,5,5,15,🏆 VIP
15293.0,301,1,247.5,1,1,2,4,⚠️ À réactiver
15294.0,36,2,222.3,3,2,1,6,⚠️ À réactiver
15295.0,290,1,217.24,1,1,1,3,⚠️ À réactiver
15296.0,49,10,6613.62,3,5,5,13,🏆 VIP
15298.0,2,16,4581.93,5,5,5,15,🏆 VIP
15299.0,8,7,3456.5299999999997,5,4,5,14,🏆 VIP
15301.0,4,6,2533.09,5,4,5,14,🏆 VIP
15302.0,358,2,291.05,1,2,2,5,⚠️ À réactiver
15303.0,201,3,604.76,1,3,3,7,🔄 Moyen
15304.0,4,2,225.15,5,2,1,8,🔄 Moyen
15305.0,191,1,93.6,1,1,1,3,⚠️ À réactiver
15306.0,136,7,2306.63,2,4,5,11,⭐ Fidèle
15309.0,246,10,715.53,1,5,3,9,🔄 Moyen
15310.0,114,1,1634.6399999999999,2,1,4,7,🔄 Moyen
15311.0,1,158,54093.73,5,5,5,15,🏆 VIP
15312.0,19,9,1995.3899999999999,4,5,4,13,🏆 VIP
15314.0,32,3,472.68,4,3,3,10,⭐ Fidèle
15317.0,313,2,112.05,1,2,1,4,⚠️ À réactiver
15321.0,53,14,3909.92,3,5,5,13,🏆 VIP
15322.0,112,1,711.18,2,1,3,6,⚠️ À réactiver
15323.0,169,4,320.9,2,4,2,8,🔄 Moyen
15324.0,337,1,140.22,1,1,1,3,⚠️ À réactiver
15325.0,31,8,1434.52,4,5,4,13,🏆 VIP
15326.0,232,9,1218.11,1,5,4,10,⭐ Fidèle
15328.0,43,1,107.24,3,1,1,5,⚠️ À réactiver
15329.0,1,16,1737.48,5,5,4,14,🏆 VIP
15331.0,135,4,755.41,2,4,3,9,🔄 Moyen
15332.0,2,6,4892.68,5,4,5,14,🏆 VIP
15336.0,37,1,240.5,3,1,2,6,⚠️ À réactiver
15337.0,38,2,344.72,3,2,2,7,🔄 Moyen
15338.0,313,1,283.43,1,1,2,4,⚠️ À réactiver
15339.0,57,8,1076.52,3,5,4,12,⭐ Fidèle
15340.0,197,1,105.5,1,1,1,3,⚠️ À réactiver
15341.0,85,2,380.5,2,2,2,6,⚠️ À réactiver
15346.0,53,3,339.23,3,3,2,8,🔄 Moyen
15347.0,2,6,1132.3,5,4,4,13,🏆 VIP
15350.0,9,2,547.6,5,2,3,10,⭐ Fidèle
15351.0,5,7,1753.04,5,4,4,13,🏆 VIP
15352.0,184,1,114.95,1,1,1,3,⚠️ À réactiver
15353.0,3,7,2377.03,5,4,5,14,🏆 VIP
15354.0,234,7,-94.8,1,4,1,6,⚠️ À réactiver
15356.0,4,4,698.45,5,4,3,12,⭐ Fidèle
15357.0,318,1,-36.75,1,1,1,3,⚠️ À réactiver
15358.0,1,28,8602.55,5,5,5,15,🏆 VIP
15359.0,190,9,162.6,1,5,1,7,🔄 Moyen
15361.0,162,3,270.15,2,3,2,7,🔄 Moyen
15362.0,84,2,613.08,2,2,3,7,🔄 Moyen
15363.0,8,2,678.11,5,2,3,10,⭐ Fidèle
15365.0,39,6,2242.81,3,4,5,12,⭐ Fidèle
15366.0,45,5,1786.57,3,4,4,11,⭐ Fidèle
15367.0,54,8,3138.04,3,5,5,13,🏆 VIP
15368.0,30,1,275.8,4,1,2,7,🔄 Moyen
15369.0,10,12,3305.88,5,5,5,15,🏆 VIP
15370.0,46,1,1352.96,3,1,4,8,🔄 Moyen
15371.0,298,1,59.4,1,1,1,3,⚠️ À réactiver
15372.0,86,9,3947.02,2,5,5,12,⭐ Fidèle
15373.0,7,6,1005.48,5,4,4,13,🏆 VIP
15374.0,260,1,139.32,1,1,1,3,⚠️ À réactiver
15375.0,326,1,60.96,1,1,1,3,⚠️ À réactiver
15377.0,18,5,1179.95,4,4,4,12,⭐ Fidèle
15378.0,98,2,246.5,2,2,2,6,⚠️ À réactiver
15379.0,36,1,1174.55,3,1,4,8,🔄 Moyen
15380.0,1,8,1739.84,5,5,4,14,🏆 VIP
15381.0,59,4,1290.77,3,4,4,11,⭐ Fidèle
15382.0,10,12,7718.64,5,5,5,15,🏆 VIP
15383.0,318,1,-10.5,1,1,1,3,⚠️ À réactiver
15384.0,8,3,1378.73,5,3,4,12,⭐ Fidèle
15385.0,28,2,625.2,4,2,3,9,🔄 Moyen
15387.0,128,1,468.65,2,1,2,5,⚠️ À réactiver
15389.0,36,4,2233.8,3,4,5,12,⭐ Fidèle
15390.0,32,2,1216.66,4,2,4,10,⭐ Fidèle
15391.0,206,2,282.92,1,2,2,5,⚠️ À réactiver
15392.0,10,3,1376.09,5,3,4,12,⭐ Fidèle
15393.0,203,3,659.48,1,3,3,7,🔄 Moyen
15394.0,31,9,3067.86,4,5,5,14,🏆 VIP
15396.0,219,1,508.2,1,1,3,5,⚠️ À réactiver
15400.0,56,3,586.1,3,3,3,9,🔄 Moyen
15401.0,88,2,216.95,2,2,1,5,⚠️ À réactiver
15402.0,23,5,1189.87,4,4,4,12,⭐ Fidèle
15403.0,127,2,170.88,2,2,1,5,⚠️ À réactiver
15404.0,11,1,257.06,5,1,2,8,🔄 Moyen
15405.0,212,1,310.74,1,1,2,4,⚠️ À réactiver
15406.0,89,2,465.16,2,2,2,6,⚠️ À réactiver
15409.0,337,2,117.2,1,2,1,4,⚠️ À réactiver
15410.0,204,2,1234.88,1,2,4,7,🔄 Moyen
15413.0,66,7,-2531.3799999999997,3,4,1,8,🔄 Moyen
15416.0,114,4,580.28,2,4,3,9,🔄 Moyen
15418.0,61,2,452.32,3,2,2,7,🔄 Moyen
15420.0,70,6,743.0,3,4,3,10,⭐ Fidèle
15421.0,21,6,2854.98,4,4,5,13,🏆 VIP
15422.0,15,6,1517.32,5,4,4,13,🏆 VIP
15423.0,217,3,175.64000000000001,1,3,1,5,⚠️ À réactiver
15424.0,99,1,214.44,2,1,1,4,⚠️ À réactiver
15425.0,36,4,1944.57,3,4,4,11,⭐ Fidèle
15426.0,4,6,1163.05,5,4,4,13,🏆 VIP
15428.0,23,3,668.97,4,3,3,10,⭐ Fidèle
15430.0,103,3,903.75,2,3,3,8,🔄 Moyen
15431.0,138,1,153.24,2,1,1,4,⚠️ À réactiver
15432.0,163,3,130.07,2,3,1,6,⚠️ À réactiver
15434.0,10,7,1519.6299999999999,5,4,4,13,🏆 VIP
15437.0,276,1,193.29,1,1,1,3,⚠️ À réactiver
15439.0,40,4,1269.05,3,4,4,11,⭐ Fidèle
15441.0,32,3,1254.21,4,3,4,11,⭐ Fidèle
15443.0,110,8,1903.98,2,5,4,11,⭐ Fidèle
15445.0,226,1,171.0,1,1,1,3,⚠️ À réactiver
15446.0,12,5,398.85,5,4,2,11,⭐ Fidèle
15447.0,163,5,329.76,2,4,2,8,🔄 Moyen
15448.0,310,1,294.17,1,1,2,4,⚠️ À réactiver
15451.0,70,2,233.21,3,2,2,7,🔄 Moyen
15452.0,26,3,1260.38,4,3,4,11,⭐ Fidèle
15454.0,254,1,128.59,1,1,1,3,⚠️ À réactiver
15455.0,233,1,38.25,1,1,1,3,⚠️ À réactiver
15456.0,39,7,1672.05,3,4,4,11,⭐ Fidèle
15458.0,38,1,208.8,3,1,1,5,⚠️ À réactiver
15459.0,53,2,202.82999999999998,3,2,1,6,⚠️ À réactiver
15461.0,96,3,391.29999999999995,2,3,2,7,🔄 Moyen
15462.0,81,1,502.45,2,1,3,6,⚠️ À réactiver
15465.0,5,16,5281.13,5,5,5,15,🏆 VIP
15466.0,25,3,1236.48,4,3,4,11,⭐ Fidèle
15468.0,21,2,949.02,4,2,4,10,⭐ Fidèle
15469.0,63,2,329.9,3,2,2,7,🔄 Moyen
15470.0,211,1,63.419999999999995,1,1,1,3,⚠️ À réactiver
15471.0,16,2,847.0799999999999,4,2,3,9,🔄 Moyen
15473.0,80,1,274.8,2,1,2,5,⚠️ À réactiver
15474.0,231,1,163.1,1,1,1,3,⚠️ À réactiver
15476.0,16,5,2180.2799999999997,4,4,5,13,🏆 VIP
15477.0,285,1,368.4,1,1,2,4,⚠️ À réactiver
15478.0,211,1,583.56,1,1,3,5,⚠️ À réactiver
15479.0,369,1,147.4,1,1,1,3,⚠️ À réactiver
15480.0,101,6,2686.75,2,4,5,11,⭐ Fidèle
15481.0,37,1,1993.34,3,1,4,8,🔄 Moyen
15482.0,22,8,1539.11,4,5,4,13,🏆 VIP
15483.0,21,6,628.39,4,4,3,11,⭐ Fidèle
15484.0,176,2,1061.69,2,2,4,8,🔄 Moyen
15485.0,9,6,3049.51,5,4,5,14,🏆 VIP
15486.0,163,1,102.0,2,1,1,4,⚠️ À réactiver
15487.0,315,1,231.32,1,1,2,4,⚠️ À réactiver
15488.0,92,4,340.6,2,4,2,8,🔄 Moyen
15489.0,36,8,1237.33,3,5,4,12,⭐ Fidèle
15490.0,66,2,188.1,3,2,1,6,⚠️ À réactiver
15493.0,25,4,2313.18,4,4,5,13,🏆 VIP
15494.0,114,4,2471.72,2,4,5,11,⭐ Fidèle
15495.0,15,1,246.5,5,1,2,8,🔄 Moyen
15496.0,267,1,146.14,1,1,1,3,⚠️ À réactiver
15497.0,10,8,7383.76,5,5,5,15,🏆 VIP
15498.0,2,23,11464.35,5,5,5,15,🏆 VIP
15499.0,359,1,161.6,1,1,1,3,⚠️ À réactiver
15501.0,40,2,402.5,3,2,2,7,🔄 Moyen
15502.0,4,10,3132.0699999999997,5,5,5,15,🏆 VIP
15503.0,362,1,120.06,1,1,1,3,⚠️ À réactiver
15504.0,156,4,361.07,2,4,2,8,🔄 Moyen
15506.0,17,3,1060.77,4,3,4,11,⭐ Fidèle
15509.0,16,1,166.51,4,1,1,6,⚠️ À réactiver
15512.0,26,2,210.57999999999998,4,2,1,7,🔄 Moyen
15513.0,1,21,12744.37,5,5,5,15,🏆 VIP
15514.0,15,7,2459.09,5,4,5,14,🏆 VIP
15515.0,23,1,171.81,4,1,1,6,⚠️ À réactiver
15518.0,15,10,2191.89,5,5,5,15,🏆 VIP
15519.0,19,2,344.61,4,2,2,8,🔄 Moyen
15521.0,36,11,4099.79,3,5,5,13,🏆 VIP
15523.0,24,17,16808.03,4,5,5,14,🏆 VIP
15524.0,242,1,151.4,1,1,1,3,⚠️ À réactiver
15525.0,9,2,469.78,5,2,2,9,🔄 Moyen
15527.0,30,21,2692.96,4,5,5,14,🏆 VIP
15529.0,2,2,1116.72,5,2,4,11,⭐ Fidèle
15530.0,148,1,311.37,2,1,2,5,⚠️ À réactiver
15532.0,12,6,2190.97,5,4,5,14,🏆 VIP
15534.0,361,1,162.25,1,1,1,3,⚠️ À réactiver
15535.0,1,4,525.92,5,4,3,12,⭐ Fidèle
15536.0,45,1,259.09,3,1,2,6,⚠️ À réactiver
15538.0,173,11,3027.15,2,5,5,12,⭐ Fidèle
15540.0,11,1,247.38,5,1,2,8,🔄 Moyen
15542.0,148,4,895.9,2,4,3,9,🔄 Moyen
15543.0,95,1,114.98,2,1,1,4,⚠️ À réactiver
15544.0,8,16,4591.61,5,5,5,15,🏆 VIP
15545.0,7,1,135.33,5,1,1,7,🔄 Moyen
15546.0,242,3,539.5500000000001,1,3,3,7,🔄 Moyen
15547.0,12,14,5186.05,5,5,5,15,🏆 VIP
15548.0,231,1,158.09,1,1,1,3,⚠️ À réactiver
15549.0,57,5,652.7,3,4,3,10,⭐ Fidèle
15550.0,14,10,1419.97,5,5,4,14,🏆 VIP
15551.0,30,8,1223.22,4,5,4,13,🏆 VIP
15552.0,259,1,162.4,1,1,1,3,⚠️ À réactiver
15555.0,1,28,6985.88,5,5,5,15,🏆 VIP
15558.0,275,2,143.32999999999998,1,2,1,4,⚠️ À réactiver
15559.0,204,1,1109.4,1,1,4,6,⚠️ À réactiver
15560.0,33,2,153.52,4,2,1,7,🔄 Moyen
15561.0,19,4,1133.8,4,4,4,12,⭐ Fidèle
15562.0,60,2,538.83,3,2,3,8,🔄 Moyen
15563.0,141,4,1461.52,2,4,4,10,⭐ Fidèle
15564.0,99,2,70.74000000000001,2,2,1,5,⚠️ À réactiver
15566.0,28,2,227.87,4,2,1,7,🔄 Moyen
15569.0,26,5,2210.64,4,4,5,13,🏆 VIP
15570.0,5,15,5137.0199999999995,5,5,5,15,🏆 VIP
15571.0,22,10,3401.2,4,5,5,14,🏆 VIP
15572.0,16,3,1515.81,4,3,4,11,⭐ Fidèle
15573.0,254,3,599.73,1,3,3,7,🔄 Moyen
15574.0,8,4,774.45,5,4,3,12,⭐ Fidèle
15575.0,255,1,30.1,1,1,1,3,⚠️ À réactiver
15577.0,359,2,139.1,1,2,1,4,⚠️ À réactiver
15579.0,19,5,918.65,4,4,3,11,⭐ Fidèle
15580.0,12,14,1221.95,5,5,4,14,🏆 VIP
15581.0,2,30,2367.81,5,5,5,15,🏆 VIP
15583.0,12,1,107.86,5,1,1,7,🔄 Moyen
15584.0,35,2,552.39,4,2,3,9,🔄 Moyen
15586.0,227,4,1128.66,1,4,4,9,🔄 Moyen
15587.0,28,3,608.4,4,3,3,10,⭐ Fidèle
15588.0,313,1,579.6,1,1,3,5,⚠️ À réactiver
15590.0,18,5,1496.6,4,4,4,12,⭐ Fidèle
15591.0,218,3,217.9,1,3,1,5,⚠️ À réactiver
15595.0,123,1,357.59999999999997,2,1,2,5,⚠️ À réactiver
15596.0,1,8,1680.25,5,5,4,14,🏆 VIP
15597.0,211,1,238.8,1,1,2,4,⚠️ À réactiver
15598.0,63,1,307.34,3,1,2,6,⚠️ À réactiver
15599.0,81,1,488.32,2,1,3,6,⚠️ À réactiver
15600.0,64,5,1178.71,3,4,4,11,⭐ Fidèle
15601.0,8,19,8173.86,5,5,5,15,🏆 VIP
15602.0,4,11,1892.34,5,5,4,14,🏆 VIP
15603.0,269,2,26.25,1,2,1,4,⚠️ À réactiver
15605.0,9,6,735.17,5,4,3,12,⭐ Fidèle
15606.0,26,8,2310.83,4,5,5,14,🏆 VIP
15607.0,179,12,1473.81,1,5,4,10,⭐ Fidèle
15608.0,51,1,692.3,3,1,3,7,🔄 Moyen
15611.0,10,17,1289.98,5,5,4,14,🏆 VIP
15613.0,246,1,433.71999999999997,1,1,2,4,⚠️ À réactiver
15614.0,64,7,3008.86,3,4,5,12,⭐ Fidèle
15615.0,26,27,10922.03,4,5,5,14,🏆 VIP
15616.0,74,1,317.11,2,1,2,5,⚠️ À réactiver
15617.0,32,3,828.55,4,3,3,10,⭐ Fidèle
15620.0,36,2,385.53,3,2,2,7,🔄 Moyen
15622.0,60,14,4093.55,3,5,5,13,🏆 VIP
15623.0,29,7,2136.02,4,4,5,13,🏆 VIP
15625.0,12,6,1698.69,5,4,4,13,🏆 VIP
15626.0,45,2,373.57,3,2,2,7,🔄 Moyen
15627.0,93,2,566.9,2,2,3,7,🔄 Moyen
15628.0,2,12,2737.72,5,5,5,15,🏆 VIP
15629.0,86,4,2240.9,2,4,5,11,⭐ Fidèle
15630.0,280,1,295.05,1,1,2,4,⚠️ À réactiver
15631.0,278,1,596.67,1,1,3,5,⚠️ À réactiver
15633.0,145,18,4173.41,2,5,5,12,⭐ Fidèle
15634.0,19,1,311.1,4,1,2,7,🔄 Moyen
15635.0,31,1,100.35,4,1,1,6,⚠️ À réactiver
15636.0,73,2,719.82,2,2,3,7,🔄 Moyen
15637.0,49,4,574.23,3,4,3,10,⭐ Fidèle
15638.0,14,8,2231.2,5,5,5,15,🏆 VIP
15639.0,85,4,603.01,2,4,3,9,🔄 Moyen
15640.0,8,18,11402.07,5,5,5,15,🏆 VIP
15641.0,32,8,3458.35,4,5,5,14,🏆 VIP
15642.0,365,1,105.77999999999999,1,1,1,3,⚠️ À réactiver
15645.0,38,3,430.56,3,3,2,8,🔄 Moyen
15646.0,8,3,526.97,5,3,3,11,⭐ Fidèle
15647.0,51,1,169.0,3,1,1,5,⚠️ À réactiver
15649.0,3,3,1354.35,5,3,4,12,⭐ Fidèle
15650.0,151,3,539.03,2,3,3,8,🔄 Moyen
15651.0,56,2,612.76,3,2,3,8,🔄 Moyen
15652.0,23,5,1074.1,4,4,4,12,⭐ Fidèle
15658.0,8,6,1311.44,5,4,4,13,🏆 VIP
15659.0,22,2,226.04,4,2,1,7,🔄 Moyen
15660.0,1,7,1212.13,5,4,4,13,🏆 VIP
15661.0,15,6,906.15,5,4,3,12,⭐ Fidèle
15662.0,297,2,283.73,1,2,2,5,⚠️ À réactiver
15664.0,64,5,853.72,3,4,3,10,⭐ Fidèle
15665.0,47,3,1773.11,3,3,4,10,⭐ Fidèle
15666.0,108,2,632.9399999999999,2,2,3,7,🔄 Moyen
15670.0,183,2,142.15,1,2,1,4,⚠️ À réactiver
15672.0,361,1,45.3,1,1,1,3,⚠️ À réactiver
15673.0,87,6,3528.82,2,4,5,11,⭐ Fidèle
15674.0,53,10,4473.83,3,5,5,13,🏆 VIP
15675.0,40,1,218.35,3,1,1,5,⚠️ À réactiver
15677.0,57,2,648.4,3,2,3,8,🔄 Moyen
15678.0,31,2,1541.19,4,2,4,10,⭐ Fidèle
15680.0,2,10,3130.8,5,5,5,15,🏆 VIP
15681.0,15,10,1533.84,5,5,4,14,🏆 VIP
15682.0,235,3,316.99,1,3,2,6,⚠️ À réactiver
15683.0,109,1,330.79,2,1,2,5,⚠️ À réactiver
15684.0,183,6,147.79999999999998,1,4,1,6,⚠️ À réactiver
15685.0,86,1,55.980000000000004,2,1,1,4,⚠️ À réactiver
15686.0,56,1,90.0,3,1,1,5,⚠️ À réactiver
15688.0,54,1,190.57,3,1,1,5,⚠️ À réactiver
15689.0,253,1,266.93,1,1,2,4,⚠️ À réactiver
15691.0,30,4,375.0,4,4,2,10,⭐ Fidèle
15693.0,295,1,37.5,1,1,1,3,⚠️ À réactiver
15694.0,1,16,4142.86,5,5,5,15,🏆 VIP
15695.0,233,2,721.06,1,2,3,6,⚠️ À réactiver
15696.0,57,9,1113.01,3,5,4,12,⭐ Fidèle
15697.0,325,1,246.75,1,1,2,4,⚠️ À réactiver
15698.0,260,1,46.2,1,1,1,3,⚠️ À réactiver
15702.0,112,2,140.39,2,2,1,5,⚠️ À réactiver
15704.0,129,4,1450.56,2,4,4,10,⭐ Fidèle
15708.0,5,5,994.26,5,4,4,13,🏆 VIP
15709.0,225,1,194.6,1,1,1,3,⚠️ À réactiver
15710.0,53,1,898.87,3,1,3,7,🔄 Moyen
15711.0,192,2,420.25,1,2,2,5,⚠️ À réactiver
15712.0,15,8,2395.1,5,5,5,15,🏆 VIP
15713.0,2,4,639.24,5,4,3,12,⭐ Fidèle
15714.0,89,3,453.93,2,3,2,7,🔄 Moyen
15715.0,191,5,658.02,1,4,3,8,🔄 Moyen
15716.0,5,8,1938.0,5,5,4,14,🏆 VIP
15717.0,57,4,456.7,3,4,2,9,🔄 Moyen
15718.0,176,1,293.79,2,1,2,5,⚠️ À réactiver
15719.0,17,25,5090.4,4,5,5,14,🏆 VIP
15720.0,186,1,143.19,1,1,1,3,⚠️ À réactiver
15722.0,81,9,2938.84,2,5,5,12,⭐ Fidèle
15723.0,47,3,744.55,3,3,3,9,🔄 Moyen
15724.0,29,2,87.5,4,2,1,7,🔄 Moyen
15726.0,26,1,321.91,4,1,2,7,🔄 Moyen
15727.0,23,8,4266.55,4,5,5,14,🏆 VIP
15728.0,15,2,544.6,5,2,3,10,⭐ Fidèle
15729.0,29,3,92.7,4,3,1,8,🔄 Moyen
15730.0,15,3,599.8,5,3,3,11,⭐ Fidèle
15731.0,189,1,125.3,1,1,1,3,⚠️ À réactiver
15732.0,8,11,1343.4,5,5,4,14,🏆 VIP
15734.0,72,2,923.85,2,2,3,7,🔄 Moyen
15735.0,57,1,327.68,3,1,2,6,⚠️ À réactiver
15736.0,66,3,1717.27,3,3,4,10,⭐ Fidèle
15738.0,1,28,8553.35,5,5,5,15,🏆 VIP
15741.0,94,2,208.62,2,2,1,5,⚠️ À réactiver
15742.0,255,1,156.87,1,1,1,3,⚠️ À réactiver
15747.0,11,7,1586.62,5,4,4,13,🏆 VIP
15748.0,85,2,465.45,2,2,2,6,⚠️ À réactiver
15750.0,1,18,4241.32,5,5,5,15,🏆 VIP
15751.0,96,14,1318.84,2,5,4,11,⭐ Fidèle
15752.0,8,3,1570.16,5,3,4,12,⭐ Fidèle
15754.0,129,8,2546.19,2,5,5,12,⭐ Fidèle
15755.0,15,12,3618.07,5,5,5,15,🏆 VIP
15757.0,22,4,2225.94,4,4,5,13,🏆 VIP
15759.0,84,7,557.9399999999999,2,4,3,9,🔄 Moyen
15760.0,266,5,-5795.87,1,4,1,6,⚠️ À réactiver
15761.0,78,1,143.05,2,1,1,4,⚠️ À réactiver
15764.0,70,4,1207.81,3,4,4,11,⭐ Fidèle
15765.0,302,1,370.63,1,1,2,4,⚠️ À réactiver
15766.0,80,3,484.6,2,3,3,8,🔄 Moyen
15767.0,277,2,-242.7,1,2,1,4,⚠️ À réactiver
15768.0,112,32,14977.63,2,5,5,12,⭐ Fidèle
15769.0,7,23,32445.66,5,5,5,15,🏆 VIP
15770.0,248,1,321.45,1,1,2,4,⚠️ À réactiver
15771.0,240,3,1006.54,1,3,4,8,🔄 Moyen
15772.0,54,1,280.88,3,1,2,6,⚠️ À réactiver
15773.0,45,1,138.84,3,1,1,5,⚠️ À réactiver
15774.0,45,6,1053.4,3,4,4,11,⭐ Fidèle
15775.0,267,1,45.599999999999994,1,1,1,3,⚠️ À réactiver
15777.0,32,4,710.55,4,4,3,11,⭐ Fidèle
15778.0,67,1,307.95,3,1,2,6,⚠️ À réactiver
15779.0,99,2,124.08,2,2,1,5,⚠️ À réactiver
15782.0,66,2,1391.71,3,2,4,9,🔄 Moyen
15784.0,103,2,848.33,2,2,3,7,🔄 Moyen
15785.0,10,18,3521.58,5,5,5,15,🏆 VIP
15786.0,46,4,3558.65,3,4,5,12,⭐ Fidèle
15788.0,136,2,215.53,2,2,1,5,⚠️ À réactiver
15789.0,67,6,1580.71,3,4,4,11,⭐ Fidèle
15791.0,142,6,1937.35,2,4,4,10,⭐ Fidèle
15792.0,35,2,933.84,4,2,3,9,🔄 Moyen
15793.0,14,5,1433.96,5,4,4,13,🏆 VIP
15794.0,372,2,777.0,1,2,3,6,⚠️ À réactiver
15795.0,66,7,1369.86,3,4,4,11,⭐ Fidèle
15796.0,10,12,2353.34,5,5,5,15,🏆 VIP
15797.0,217,2,613.6800000000001,1,2,3,6,⚠️ À réactiver
15798.0,128,3,1535.37,2,3,4,9,🔄 Moyen
15799.0,54,1,540.15,3,1,3,7,🔄 Moyen
15800.0,89,5,543.5,2,4,3,9,🔄 Moyen
15803.0,81,3,1513.84,2,3,4,9,🔄 Moyen
15805.0,21,20,4256.75,4,5,5,14,🏆 VIP
15807.0,44,3,903.67,3,3,3,9,🔄 Moyen
15808.0,5,20,14524.06,5,5,5,15,🏆 VIP
15809.0,91,3,463.67,2,3,2,7,🔄 Moyen
15810.0,22,6,1579.37,4,4,4,12,⭐ Fidèle
15811.0,1,2,1671.9,5,2,4,11,⭐ Fidèle
15812.0,71,8,3385.03,2,5,5,12,⭐ Fidèle
15814.0,29,2,689.11,4,2,3,9,🔄 Moyen
15816.0,178,3,93.3,1,3,1,5,⚠️ À réactiver
15817.0,56,3,2766.4,3,3,5,11,⭐ Fidèle
15818.0,224,1,340.5,1,1,2,4,⚠️ À réactiver
15819.0,67,7,2005.83,3,4,4,11,⭐ Fidèle
15822.0,129,6,892.44,2,4,3,9,🔄 Moyen
15823.0,8,5,3874.62,5,4,5,14,🏆 VIP
15824.0,89,2,890.94,2,2,3,7,🔄 Moyen
15826.0,199,2,933.77,1,2,3,6,⚠️ À réactiver
15827.0,8,24,1789.48,5,5,4,14,🏆 VIP
15828.0,11,1,1108.82,5,1,4,10,⭐ Fidèle
15833.0,373,1,80.4,1,1,1,3,⚠️ À réactiver
15834.0,8,4,1515.39,5,4,4,13,🏆 VIP
15837.0,121,1,385.03,2,1,2,5,⚠️ À réactiver
15838.0,3,19,40053.35,5,5,5,15,🏆 VIP
15841.0,22,6,1507.4,4,4,4,12,⭐ Fidèle
15842.0,24,3,528.75,4,3,3,10,⭐ Fidèle
15845.0,172,4,622.78,2,4,3,9,🔄 Moyen
15846.0,21,1,107.01,4,1,1,6,⚠️ À réactiver
15847.0,64,3,433.3,3,3,2,8,🔄 Moyen
15848.0,257,1,139.94,1,1,1,3,⚠️ À réactiver
15849.0,232,1,-5876.34,1,1,1,3,⚠️ À réactiver
15850.0,12,4,819.87,5,4,3,12,⭐ Fidèle
15851.0,162,1,109.73,2,1,1,4,⚠️ À réactiver
15852.0,162,1,96.55,2,1,1,4,⚠️ À réactiver
15854.0,12,9,2609.16,5,5,5,15,🏆 VIP
15855.0,112,1,340.48,2,1,2,5,⚠️ À réactiver
15856.0,1,28,17643.77,5,5,5,15,🏆 VIP
15857.0,66,1,273.48,3,1,2,6,⚠️ À réactiver
15858.0,3,11,2479.02,5,5,5,15,🏆 VIP
15859.0,68,1,438.46,3,1,2,6,⚠️ À réactiver
15860.0,4,10,1528.0,5,5,4,14,🏆 VIP
15861.0,92,6,1217.63,2,4,4,10,⭐ Fidèle
15862.0,9,10,2095.41,5,5,5,15,🏆 VIP
15863.0,253,3,289.86,1,3,2,6,⚠️ À réactiver
15864.0,17,1,244.44,4,1,2,7,🔄 Moyen
15865.0,49,2,1353.79,3,2,4,9,🔄 Moyen
15867.0,5,20,5177.06,5,5,5,15,🏆 VIP
15868.0,219,1,94.53,1,1,1,3,⚠️ À réactiver
15869.0,262,1,174.01999999999998,1,1,1,3,⚠️ À réactiver
15870.0,32,3,508.52000000000004,4,3,3,10,⭐ Fidèle
15871.0,73,1,33.099999999999994,2,1,1,4,⚠️ À réactiver
15872.0,14,2,434.75,5,2,2,9,🔄 Moyen
15873.0,128,5,138.23999999999998,2,4,1,7,🔄 Moyen
15874.0,23,16,6804.33,4,5,5,14,🏆 VIP
15875.0,282,1,111.72,1,1,1,3,⚠️ À réactiver
15876.0,45,2,1449.14,3,2,4,9,🔄 Moyen
15878.0,197,2,330.77,1,2,2,5,⚠️ À réactiver
15879.0,40,4,1157.3,3,4,4,11,⭐ Fidèle
15880.0,5,2,313.28,5,2,2,9,🔄 Moyen
15882.0,4,8,953.55,5,5,4,14,🏆 VIP
15884.0,68,3,243.75,3,3,2,8,🔄 Moyen
15885.0,19,17,1358.22,4,5,4,13,🏆 VIP
15886.0,52,3,871.78,3,3,3,9,🔄 Moyen
15887.0,42,3,1027.15,3,3,4,10,⭐ Fidèle
15888.0,36,2,260.85,3,2,2,7,🔄 Moyen
15889.0,5,8,1348.96,5,5,4,14,🏆 VIP
15890.0,30,5,535.65,4,4,3,11,⭐ Fidèle
15892.0,305,1,128.2,1,1,1,3,⚠️ À réactiver
15893.0,117,1,305.28,2,1,2,5,⚠️ À réactiver
15894.0,5,1,156.74,5,1,1,7,🔄 Moyen
15896.0,260,1,-1899.67,1,1,1,3,⚠️ À réactiver
15898.0,3,25,4149.68,5,5,5,15,🏆 VIP
15899.0,4,1,56.25,5,1,1,7,🔄 Moyen
15900.0,49,4,539.39,3,4,3,10,⭐ Fidèle
15901.0,87,6,320.35,2,4,2,8,🔄 Moyen
15902.0,16,1,145.01,4,1,1,6,⚠️ À réactiver
15903.0,14,7,3733.48,5,4,5,14,🏆 VIP
15905.0,179,1,114.69,1,1,1,3,⚠️ À réactiver
15906.0,10,4,946.1,5,4,4,13,🏆 VIP
15908.0,126,2,764.57,2,2,3,7,🔄 Moyen
15910.0,36,7,1449.6200000000001,3,4,4,11,⭐ Fidèle
15911.0,84,10,1401.55,2,5,4,11,⭐ Fidèle
15912.0,72,7,810.08,2,4,3,9,🔄 Moyen
15913.0,170,1,6.3,2,1,1,4,⚠️ À réactiver
15914.0,14,2,205.99,5,2,1,8,🔄 Moyen
15915.0,37,1,429.21,3,1,2,6,⚠️ À réactiver
15916.0,2,10,1786.43,5,5,4,14,🏆 VIP
15917.0,242,4,437.53,1,4,2,7,🔄 Moyen
15918.0,267,1,248.65,1,1,2,4,⚠️ À réactiver
15919.0,4,1,270.72,5,1,2,8,🔄 Moyen
15920.0,60,5,404.14,3,4,2,9,🔄 Moyen
15921.0,32,3,466.08,4,3,2,9,🔄 Moyen
15922.0,8,2,363.6,5,2,2,9,🔄 Moyen
15923.0,8,1,127.08,5,1,1,7,🔄 Moyen
15924.0,367,1,102.82,1,1,1,3,⚠️ À réactiver
15926.0,178,1,134.44,1,1,1,3,⚠️ À réactiver
15927.0,283,1,123.39,1,1,1,3,⚠️ À réactiver
15928.0,292,1,293.53,1,1,2,4,⚠️ À réactiver
15929.0,280,1,594.0,1,1,3,5,⚠️ À réactiver
15931.0,64,1,239.9,3,1,2,6,⚠️ À réactiver
15934.0,53,2,2190.66,3,2,5,10,⭐ Fidèle
15935.0,367,1,-308.82,1,1,1,3,⚠️ À réactiver
15936.0,15,2,282.79,5,2,2,9,🔄 Moyen
15938.0,92,4,330.23,2,4,2,8,🔄 Moyen
15939.0,10,1,2945.38,5,1,5,11,⭐ Fidèle
15940.0,45,1,-31.8,3,1,1,5,⚠️ À réactiver
15941.0,149,2,230.6,2,2,1,5,⚠️ À réactiver
15943.0,285,2,271.28999999999996,1,2,2,5,⚠️ À réactiver
15944.0,29,3,1839.1399999999999,4,3,4,11,⭐ Fidèle
15945.0,1,4,646.27,5,4,3,12,⭐ Fidèle
15946.0,138,3,2304.18,2,3,5,10,⭐ Fidèle
15948.0,60,1,553.85,3,1,3,7,🔄 Moyen
15950.0,11,8,5233.25,5,5,5,15,🏆 VIP
15951.0,17,1,304.95,4,1,2,7,🔄 Moyen
15953.0,5,12,1890.17,5,5,4,14,🏆 VIP
15954.0,225,1,190.75,1,1,1,3,⚠️ À réactiver
15955.0,8,10,4232.8,5,5,5,15,🏆 VIP
15956.0,187,2,617.6,1,2,3,6,⚠️ À réactiver
15957.0,56,2,501.21,3,2,3,8,🔄 Moyen
15958.0,39,3,388.64,3,3,2,8,🔄 Moyen
15959.0,318,3,579.49,1,3,3,7,🔄 Moyen
15960.0,10,5,394.0,5,4,2,11,⭐ Fidèle
15961.0,15,1,451.28999999999996,5,1,2,8,🔄 Moyen
15962.0,85,1,295.83,2,1,2,5,⚠️ À réactiver
15964.0,299,1,272.96,1,1,2,4,⚠️ À réactiver
15965.0,3,11,2153.7,5,5,5,15,🏆 VIP
15966.0,80,2,399.58,2,2,2,6,⚠️ À réactiver
15967.0,15,11,2600.37,5,5,5,15,🏆 VIP
15968.0,24,1,418.05,4,1,2,7,🔄 Moyen
15969.0,61,2,460.95,3,2,2,7,🔄 Moyen
15970.0,234,1,703.22,1,1,3,5,⚠️ À réactiver
15971.0,21,8,730.58,4,5,3,12,⭐ Fidèle
15972.0,92,5,1810.27,2,4,4,10,⭐ Fidèle
15973.0,2,3,680.62,5,3,3,11,⭐ Fidèle
15976.0,46,4,1315.7,3,4,4,11,⭐ Fidèle
15978.0,59,4,2173.84,3,4,5,12,⭐ Fidèle
15979.0,238,1,329.21999999999997,1,1,2,4,⚠️ À réactiver
15980.0,100,6,4147.42,2,4,5,11,⭐ Fidèle
15981.0,31,19,5859.59,4,5,5,14,🏆 VIP
15982.0,241,1,324.51,1,1,2,4,⚠️ À réactiver
15983.0,1,6,2483.8,5,4,5,14,🏆 VIP
15984.0,4,22,5854.15,5,5,5,15,🏆 VIP
15985.0,72,5,1572.86,2,4,4,10,⭐ Fidèle
15986.0,17,1,186.29999999999998,4,1,1,6,⚠️ À réactiver
15987.0,4,2,230.85,5,2,2,9,🔄 Moyen
15988.0,187,2,612.06,1,2,3,6,⚠️ À réactiver
15989.0,11,2,372.51,5,2,2,9,🔄 Moyen
15990.0,130,5,1217.94,2,4,4,10,⭐ Fidèle
15991.0,170,1,150.55,2,1,1,4,⚠️ À réactiver
15992.0,32,2,854.61,4,2,3,9,🔄 Moyen
15994.0,47,4,771.77,3,4,3,10,⭐ Fidèle
15995.0,50,1,696.1899999999999,3,1,3,7,🔄 Moyen
15996.0,2,2,626.22,5,2,3,10,⭐ Fidèle
15997.0,253,1,-23.4,1,1,1,3,⚠️ À réactiver
15998.0,29,15,5136.22,4,5,5,14,🏆 VIP
15999.0,371,1,20.4,1,1,1,3,⚠️ À réactiver
16001.0,17,2,519.06,4,2,3,9,🔄 Moyen
16002.0,261,1,169.21,1,1,1,3,⚠️ À réactiver
16003.0,17,5,2878.46,4,4,5,13,🏆 VIP
16004.0,110,5,2146.39,2,4,5,11,⭐ Fidèle
16005.0,11,7,1788.38,5,4,4,13,🏆 VIP
16006.0,23,1,245.77,4,1,2,7,🔄 Moyen
16007.0,19,3,1373.2,4,3,4,11,⭐ Fidèle
16008.0,18,12,4905.35,4,5,5,14,🏆 VIP
16010.0,12,9,1314.61,5,5,4,14,🏆 VIP
16011.0,2,15,2504.3,5,5,5,15,🏆 VIP
16012.0,37,2,1574.5,3,2,4,9,🔄 Moyen
16013.0,7,42,19422.67,5,5,5,15,🏆 VIP
16014.0,44,2,467.89,3,2,2,7,🔄 Moyen
16016.0,2,6,1011.73,5,4,4,13,🏆 VIP
16017.0,53,4,1341.95,3,4,4,11,⭐ Fidèle
16018.0,32,2,289.23,4,2,2,8,🔄 Moyen
16019.0,17,25,13189.91,4,5,5,14,🏆 VIP
16021.0,31,2,532.25,4,2,3,9,🔄 Moyen
16024.0,47,2,232.96,3,2,2,7,🔄 Moyen
16027.0,93,11,947.72,2,5,4,11,⭐ Fidèle
16028.0,231,1,82.2,1,1,1,3,⚠️ À réactiver
16029.0,8,52,40808.3,5,5,5,15,🏆 VIP
16032.0,92,6,1970.45,2,4,4,10,⭐ Fidèle
16033.0,5,10,1964.78,5,5,4,14,🏆 VIP
16034.0,30,4,488.07,4,4,3,11,⭐ Fidèle
16035.0,196,1,217.73,1,1,1,3,⚠️ À réactiver
16036.0,60,2,1797.92,3,2,4,9,🔄 Moyen
16037.0,176,4,634.42,2,4,3,9,🔄 Moyen
16039.0,59,3,449.65,3,3,2,8,🔄 Moyen
16040.0,66,5,1070.15,3,4,4,11,⭐ Fidèle
16042.0,1,6,1005.63,5,4,4,13,🏆 VIP
16043.0,15,4,1082.6,5,4,4,13,🏆 VIP
16044.0,71,1,340.84,2,1,2,5,⚠️ À réactiver
16045.0,52,5,1846.33,3,4,4,11,⭐ Fidèle
16046.0,198,1,235.78,1,1,2,4,⚠️ À réactiver
16047.0,318,1,107.14,1,1,1,3,⚠️ À réactiver
16048.0,9,5,812.84,5,4,3,12,⭐ Fidèle
16049.0,11,3,787.89,5,3,3,11,⭐ Fidèle
16050.0,19,2,162.8,4,2,1,7,🔄 Moyen
16051.0,317,1,188.44,1,1,1,3,⚠️ À réactiver
16053.0,49,6,2094.19,3,4,5,12,⭐ Fidèle
16054.0,54,6,1306.78,3,4,4,11,⭐ Fidèle
16057.0,67,7,1061.85,3,4,4,11,⭐ Fidèle
16058.0,42,1,62.7,3,1,1,5,⚠️ À réactiver
16059.0,3,7,1757.91,5,4,4,13,🏆 VIP
16060.0,36,3,541.95,3,3,3,9,🔄 Moyen
16061.0,56,2,74.9,3,2,1,6,⚠️ À réactiver
16062.0,15,4,1709.83,5,4,4,13,🏆 VIP
16064.0,361,1,111.0,1,1,1,3,⚠️ À réactiver
16065.0,1,10,1993.53,5,5,4,14,🏆 VIP
16067.0,198,6,3026.19,1,4,5,10,⭐ Fidèle
16068.0,229,1,122.93,1,1,1,3,⚠️ À réactiver
16069.0,53,1,457.7,3,1,2,6,⚠️ À réactiver
16071.0,163,3,750.56,2,3,3,8,🔄 Moyen
16072.0,64,3,3744.57,3,3,5,11,⭐ Fidèle
16074.0,26,1,265.25,4,1,2,7,🔄 Moyen
16075.0,138,3,726.98,2,3,3,8,🔄 Moyen
16077.0,210,2,599.9999999999998,1,2,3,6,⚠️ À réactiver
16078.0,305,1,283.79,1,1,2,4,⚠️ À réactiver
16080.0,21,3,296.3,4,3,2,9,🔄 Moyen
16081.0,2,4,1653.28,5,4,4,13,🏆 VIP
16082.0,306,1,106.75,1,1,1,3,⚠️ À réactiver
16083.0,18,2,1033.8,4,2,4,10,⭐ Fidèle
16085.0,16,8,1356.22,4,5,4,13,🏆 VIP
16086.0,3,6,1743.6,5,4,4,13,🏆 VIP
16087.0,25,5,1739.92,4,4,4,12,⭐ Fidèle
16088.0,211,2,1437.43,1,2,4,7,🔄 Moyen
16089.0,22,2,271.44,4,2,2,8,🔄 Moyen
16090.0,260,1,205.91,1,1,1,3,⚠️ À réactiver
16092.0,140,5,736.13,2,4,3,9,🔄 Moyen
16094.0,11,13,2557.33,5,5,5,15,🏆 VIP
16095.0,92,1,447.05,2,1,2,5,⚠️ À réactiver
16096.0,52,3,1264.3500000000001,3,3,4,10,⭐ Fidèle
16098.0,9,8,2442.47,5,5,5,15,🏆 VIP
16099.0,53,5,836.35,3,4,3,10,⭐ Fidèle
16100.0,98,1,582.64,2,1,3,6,⚠️ À réactiver
16101.0,70,4,1921.46,3,4,4,11,⭐ Fidèle
16103.0,25,21,4573.12,4,5,5,14,🏆 VIP
16104.0,54,10,2213.0,3,5,5,13,🏆 VIP
16105.0,74,4,2049.23,2,4,4,10,⭐ Fidèle
16108.0,66,6,1355.83,3,4,4,11,⭐ Fidèle
16109.0,283,2,311.7,1,2,2,5,⚠️ À réactiver
16110.0,158,1,481.79,2,1,3,6,⚠️ À réactiver
16111.0,64,1,562.48,3,1,3,7,🔄 Moyen
16115.0,33,4,907.17,4,4,3,11,⭐ Fidèle
16117.0,38,3,417.84,3,3,2,8,🔄 Moyen
16118.0,29,5,4255.43,4,4,5,13,🏆 VIP
16119.0,30,6,1297.45,4,4,4,12,⭐ Fidèle
16120.0,58,2,1747.77,3,2,4,9,🔄 Moyen
16121.0,16,4,590.08,4,4,3,11,⭐ Fidèle
16122.0,2,3,316.92,5,3,2,10,⭐ Fidèle
16124.0,54,4,1522.24,3,4,4,11,⭐ Fidèle
16125.0,3,14,4298.3,5,5,5,15,🏆 VIP
16126.0,15,11,8359.03,5,5,5,15,🏆 VIP
16127.0,362,1,145.06,1,1,1,3,⚠️ À réactiver
16128.0,16,9,1868.18,4,5,4,13,🏆 VIP
16129.0,43,3,1396.05,3,3,4,10,⭐ Fidèle
16130.0,58,4,987.48,3,4,4,11,⭐ Fidèle
16131.0,11,9,6359.73,5,5,5,15,🏆 VIP
16132.0,180,2,664.1999999999999,1,2,3,6,⚠️ À réactiver
16133.0,12,32,7923.22,5,5,5,15,🏆 VIP
16134.0,59,4,1516.3,3,4,4,11,⭐ Fidèle
16135.0,219,1,301.9,1,1,2,4,⚠️ À réactiver
16136.0,278,2,211.70000000000002,1,2,1,4,⚠️ À réactiver
16137.0,316,1,422.7,1,1,2,4,⚠️ À réactiver
16138.0,4,4,902.4,5,4,3,12,⭐ Fidèle
16139.0,358,2,475.74,1,2,3,6,⚠️ À réactiver
16140.0,7,2,832.42,5,2,3,10,⭐ Fidèle
16141.0,53,1,335.54,3,1,2,6,⚠️ À réactiver
16143.0,5,10,2447.04,5,5,5,15,🏆 VIP
16145.0,21,11,2951.62,4,5,5,14,🏆 VIP
16146.0,84,1,212.25,2,1,1,4,⚠️ À réactiver
16147.0,36,6,1992.02,3,4,4,11,⭐ Fidèle
16148.0,72,3,294.05,2,3,2,7,🔄 Moyen
16149.0,65,1,141.7,3,1,1,5,⚠️ À réactiver
16150.0,8,11,2248.62,5,5,5,15,🏆 VIP
16151.0,234,1,-4217.59,1,1,1,3,⚠️ À réactiver
16153.0,46,8,3213.2799999999997,3,5,5,13,🏆 VIP
16154.0,318,1,-10.5,1,1,1,3,⚠️ À réactiver
16155.0,17,6,781.05,4,4,3,11,⭐ Fidèle
16156.0,18,13,2908.97,4,5,5,14,🏆 VIP
16158.0,158,10,611.32,2,5,3,10,⭐ Fidèle
16159.0,88,4,882.09,2,4,3,9,🔄 Moyen
16161.0,4,33,7095.99,5,5,5,15,🏆 VIP
16163.0,1,12,1822.03,5,5,4,14,🏆 VIP
16165.0,141,1,79.9,2,1,1,4,⚠️ À réactiver
16166.0,64,4,327.48,3,4,2,9,🔄 Moyen
16167.0,50,6,1149.87,3,4,4,11,⭐ Fidèle
16168.0,5,46,6768.48,5,5,5,15,🏆 VIP
16170.0,31,18,4933.25,4,5,5,14,🏆 VIP
16172.0,109,3,744.34,2,3,3,8,🔄 Moyen
16174.0,127,4,1237.2,2,4,4,10,⭐ Fidèle
16175.0,107,3,798.85,2,3,3,8,🔄 Moyen
16176.0,57,7,1964.04,3,4,4,11,⭐ Fidèle
16177.0,70,11,1809.66,3,5,4,12,⭐ Fidèle
16178.0,37,1,414.7,3,1,2,6,⚠️ À réactiver
16180.0,114,6,5952.79,2,4,5,11,⭐ Fidèle
16182.0,74,5,3354.0,2,4,5,11,⭐ Fidèle
16183.0,30,3,739.1,4,3,3,10,⭐ Fidèle
16185.0,200,1,115.31,1,1,1,3,⚠️ À réactiver
16186.0,8,18,4991.97,5,5,5,15,🏆 VIP
16188.0,43,2,95.85,3,2,1,6,⚠️ À réactiver
16190.0,30,7,2508.47,4,4,5,13,🏆 VIP
16191.0,11,15,10248.8,5,5,5,15,🏆 VIP
16192.0,371,1,351.3,1,1,2,4,⚠️ À réactiver
16193.0,46,1,315.98,3,1,2,6,⚠️ À réactiver
16194.0,11,1,308.6,5,1,2,8,🔄 Moyen
16195.0,359,1,323.25,1,1,2,4,⚠️ À réactiver
16196.0,124,1,93.3,2,1,1,4,⚠️ À réactiver
16197.0,105,9,2016.71,2,5,4,11,⭐ Fidèle
16198.0,73,1,629.36,2,1,3,6,⚠️ À réactiver
16199.0,28,7,942.75,4,4,4,12,⭐ Fidèle
16200.0,18,11,4549.33,4,5,5,14,🏆 VIP
16201.0,51,1,248.65,3,1,2,6,⚠️ À réactiver
16202.0,53,10,2101.77,3,5,5,13,🏆 VIP
16203.0,8,3,521.64,5,3,3,11,⭐ Fidèle
16204.0,16,3,533.53,4,3,3,10,⭐ Fidèle
16205.0,32,3,1069.23,4,3,4,11,⭐ Fidèle
16206.0,23,10,2060.31,4,5,5,14,🏆 VIP
16208.0,30,8,2776.19,4,5,5,14,🏆 VIP
16209.0,18,4,1884.16,4,4,4,12,⭐ Fidèle
16210.0,4,21,17217.76,5,5,5,15,🏆 VIP
16211.0,57,2,543.5699999999999,3,2,3,8,🔄 Moyen
16212.0,254,2,603.37,1,2,3,6,⚠️ À réactiver
16214.0,71,1,975.5,2,1,4,7,🔄 Moyen
16218.0,9,12,1288.73,5,5,4,14,🏆 VIP
16219.0,136,1,40.8,2,1,1,4,⚠️ À réactiver
16220.0,364,1,-10.17,1,1,1,3,⚠️ À réactiver
16221.0,3,8,1364.15,5,5,4,14,🏆 VIP
16222.0,357,1,498.5,1,1,3,5,⚠️ À réactiver
16223.0,10,2,1102.35,5,2,4,11,⭐ Fidèle
16224.0,23,1,321.24,4,1,2,7,🔄 Moyen
16225.0,38,13,1725.59,3,5,4,12,⭐ Fidèle
16226.0,14,2,417.05,5,2,2,9,🔄 Moyen
16227.0,115,4,640.5,2,4,3,9,🔄 Moyen
16228.0,10,4,886.16,5,4,3,12,⭐ Fidèle
16229.0,17,5,1824.76,4,4,4,12,⭐ Fidèle
16231.0,15,4,1078.22,5,4,4,13,🏆 VIP
16232.0,56,5,1708.79,3,4,4,11,⭐ Fidèle
16233.0,2,8,1396.58,5,5,4,14,🏆 VIP
16234.0,109,4,312.78,2,4,2,8,🔄 Moyen
16235.0,11,5,1132.2,5,4,4,13,🏆 VIP
16237.0,73,1,136.65,2,1,1,4,⚠️ À réactiver
16238.0,58,1,63.66,3,1,1,5,⚠️ À réactiver
16239.0,18,4,1078.0,4,4,4,12,⭐ Fidèle
16241.0,5,4,1721.44,5,4,4,13,🏆 VIP
16242.0,17,10,3835.04,4,5,5,14,🏆 VIP
16244.0,8,1,1056.6299999999999,5,1,4,10,⭐ Fidèle
16246.0,95,2,827.25,2,2,3,7,🔄 Moyen
16250.0,9,2,401.94,5,2,2,9,🔄 Moyen
16251.0,148,1,128.31,2,1,1,4,⚠️ À réactiver
16252.0,2,2,-2.6645352591003757e-15,5,2,1,8,🔄 Moyen
16253.0,56,6,3611.29,3,4,5,12,⭐ Fidèle
16254.0,14,3,985.14,5,3,4,12,⭐ Fidèle
16255.0,1,10,2225.09,5,5,5,15,🏆 VIP
16256.0,129,2,876.9399999999999,2,3,3,8,🔄 Moyen
16258.0,23,11,6630.01,4,5,5,14,🏆 VIP
16259.0,46,3,361.94,3,3,2,8,🔄 Moyen
16261.0,22,2,312.62,4,3,2,9,🔄 Moyen
16262.0,14,2,709.43,5,3,3,11,⭐ Fidèle
16263.0,59,1,351.01,3,1,2,6,⚠️ À réactiver
16264.0,74,2,837.53,2,3,3,8,🔄 Moyen
16265.0,22,4,1470.47,4,4,4,12,⭐ Fidèle
16266.0,59,7,896.06,3,4,3,10,⭐ Fidèle
16267.0,227,1,186.66,1,1,1,3,⚠️ À réactiver
16269.0,64,2,714.59,3,3,3,9,🔄 Moyen
16271.0,93,5,2033.78,2,4,4,10,⭐ Fidèle
16273.0,284,2,336.03999999999996,1,3,2,6,⚠️ À réactiver
16274.0,9,1,357.95,5,1,2,8,🔄 Moyen
16275.0,110,2,1591.24,2,3,4,9,🔄 Moyen
16276.0,115,2,1818.79,2,3,4,9,🔄 Moyen
16277.0,369,1,188.69,1,1,1,3,⚠️ À réactiver
16278.0,113,4,518.76,2,4,3,9,🔄 Moyen
16279.0,21,6,4195.5,4,4,5,13,🏆 VIP
16280.0,361,1,238.04999999999998,1,1,2,4,⚠️ À réactiver
16281.0,58,3,1354.46,3,3,4,10,⭐ Fidèle
16282.0,123,2,1139.28,2,3,4,9,🔄 Moyen
16283.0,54,5,2779.86,3,4,5,12,⭐ Fidèle
16284.0,29,1,205.8,4,1,1,6,⚠️ À réactiver
16285.0,282,1,176.9,1,1,1,3,⚠️ À réactiver
16286.0,113,4,263.65000000000003,2,4,2,8,🔄 Moyen
16287.0,12,4,864.48,5,4,3,12,⭐ Fidèle
16288.0,106,1,129.85,2,1,1,4,⚠️ À réactiver
16289.0,98,2,98.81,2,3,1,6,⚠️ À réactiver
16290.0,100,4,2069.3,2,4,5,11,⭐ Fidèle
16291.0,318,1,117.72,1,1,1,3,⚠️ À réactiver
16292.0,11,7,890.56,5,4,3,12,⭐ Fidèle
16293.0,3,8,2395.46,5,5,5,15,🏆 VIP
16294.0,112,1,126.05,2,1,1,4,⚠️ À réactiver
16296.0,262,6,1245.97,1,4,4,9,🔄 Moyen
16298.0,33,6,481.8,4,4,3,11,⭐ Fidèle
16299.0,108,2,178.65,2,3,1,6,⚠️ À réactiver
16300.0,66,3,1392.43,3,3,4,10,⭐ Fidèle
16301.0,372,1,107.33,1,1,1,3,⚠️ À réactiver
16303.0,28,5,2517.89,4,4,5,13,🏆 VIP
16304.0,330,1,381.65999999999997,1,1,2,4,⚠️ À réactiver
16306.0,3,2,560.55,5,3,3,11,⭐ Fidèle
16307.0,65,3,1194.92,3,3,4,10,⭐ Fidèle
16308.0,42,3,2560.0,3,3,5,11,⭐ Fidèle
16310.0,50,2,460.08,3,3,2,8,🔄 Moyen
16312.0,68,1,171.15,3,1,1,5,⚠️ À réactiver
16314.0,25,3,1491.4,4,3,4,11,⭐ Fidèle
16315.0,172,1,176.34,2,1,1,4,⚠️ À réactiver
16316.0,16,7,2777.75,4,4,5,13,🏆 VIP
16317.0,186,3,838.11,1,3,3,7,🔄 Moyen
16320.0,89,6,3390.39,2,4,5,11,⭐ Fidèle
16321.0,262,3,34.8,1,3,1,5,⚠️ À réactiver
16323.0,213,1,146.16,1,1,1,3,⚠️ À réactiver
16325.0,59,12,2953.3,3,5,5,13,🏆 VIP
16326.0,19,11,1621.03,4,5,4,13,🏆 VIP
16327.0,5,15,6861.3,5,5,5,15,🏆 VIP
16328.0,199,1,310.83,1,1,2,4,⚠️ À réactiver
16329.0,63,4,1703.07,3,4,4,11,⭐ Fidèle
16330.0,60,4,382.42,3,4,2,9,🔄 Moyen
16331.0,68,6,2037.7,3,4,4,11,⭐ Fidèle
16332.0,67,5,406.77,3,4,2,9,🔄 Moyen
16334.0,128,1,277.48,2,1,2,5,⚠️ À réactiver
16335.0,187,8,2747.0,1,5,5,11,⭐ Fidèle
16336.0,56,4,3517.69,3,4,5,12,⭐ Fidèle
16340.0,75,2,976.99,2,3,4,9,🔄 Moyen
16341.0,73,4,1872.91,2,4,4,10,⭐ Fidèle
16343.0,43,1,316.59000000000003,3,1,2,6,⚠️ À réactiver
16344.0,145,3,741.3199999999999,2,3,3,8,🔄 Moyen
16345.0,119,1,623.33,2,1,3,6,⚠️ À réactiver
16346.0,21,1,224.51,4,1,1,6,⚠️ À réactiver
16347.0,24,11,2594.36,4,5,5,14,🏆 VIP
16348.0,66,1,328.77,3,1,2,6,⚠️ À réactiver
16350.0,1,8,1106.02,5,5,4,14,🏆 VIP
16351.0,47,17,3125.23,3,5,5,13,🏆 VIP
16353.0,5,19,3310.22,5,5,5,15,🏆 VIP
16354.0,15,3,733.71,5,3,3,11,⭐ Fidèle
16355.0,10,2,349.2,5,3,2,10,⭐ Fidèle
16356.0,12,3,204.1,5,3,1,9,🔄 Moyen
16357.0,17,1,209.49,4,1,1,6,⚠️ À réactiver
16358.0,30,1,892.15,4,1,3,8,🔄 Moyen
16359.0,12,8,919.03,5,5,3,13,🏆 VIP
16362.0,66,2,189.67,3,3,1,7,🔄 Moyen
16365.0,3,8,1756.38,5,5,4,14,🏆 VIP
16366.0,218,3,1220.83,1,3,4,8,🔄 Moyen
16367.0,19,1,557.91,4,1,3,8,🔄 Moyen
16368.0,71,1,142.78,2,1,1,4,⚠️ À réactiver
16369.0,72,4,1111.15,2,4,4,10,⭐ Fidèle
16371.0,84,1,157.2,2,1,1,4,⚠️ À réactiver
16372.0,38,4,930.68,3,4,3,10,⭐ Fidèle
16373.0,18,2,309.49,4,3,2,9,🔄 Moyen
16374.0,38,3,1298.42,3,3,4,10,⭐ Fidèle
16375.0,106,2,104.0,2,3,1,6,⚠️ À réactiver
16377.0,253,1,632.28,1,1,3,5,⚠️ À réactiver
16381.0,31,2,258.7,4,3,2,9,🔄 Moyen
16382.0,44,2,353.1,3,3,2,8,🔄 Moyen
16383.0,32,7,2242.48,4,4,5,13,🏆 VIP
16384.0,65,2,774.45,3,3,3,9,🔄 Moyen
16385.0,2,3,474.71999999999997,5,3,3,11,⭐ Fidèle
16386.0,23,1,785.39,4,1,3,8,🔄 Moyen
16387.0,31,4,824.19,4,4,3,11,⭐ Fidèle
16388.0,289,1,186.05,1,1,1,3,⚠️ À réactiver
16390.0,172,3,467.5,2,3,2,7,🔄 Moyen
16391.0,36,4,1103.61,3,4,4,11,⭐ Fidèle
16392.0,49,2,541.86,3,3,3,9,🔄 Moyen
16393.0,5,11,2515.45,5,5,5,15,🏆 VIP
16395.0,29,12,1972.05,4,5,4,13,🏆 VIP
16396.0,109,3,102.7,2,3,1,6,⚠️ À réactiver
16397.0,264,1,127.88,1,1,1,3,⚠️ À réactiver
16399.0,25,1,233.25,4,1,2,7,🔄 Moyen
16400.0,31,8,2855.5099999999998,4,5,5,14,🏆 VIP
16401.0,15,19,2567.75,5,5,5,15,🏆 VIP
16402.0,5,1,211.8,5,1,1,7,🔄 Moyen
16404.0,368,1,-12.75,1,1,1,3,⚠️ À réactiver
16406.0,86,3,370.91,2,3,2,7,🔄 Moyen
16407.0,25,4,694.72,4,4,3,11,⭐ Fidèle
16408.0,227,1,231.93,1,1,2,4,⚠️ À réactiver
16409.0,16,7,3680.16,4,4,5,13,🏆 VIP
16410.0,370,1,130.32,1,1,1,3,⚠️ À réactiver
16411.0,5,3,695.54,5,3,3,11,⭐ Fidèle
16412.0,29,4,495.4,4,4,3,11,⭐ Fidèle
16413.0,11,1,266.78000000000003,5,1,2,8,🔄 Moyen
16414.0,67,3,433.46,3,3,2,8,🔄 Moyen
16415.0,219,2,509.09000000000003,1,3,3,7,🔄 Moyen
16416.0,26,6,1921.48,4,4,4,12,⭐ Fidèle
16417.0,128,1,35.7,2,1,1,4,⚠️ À réactiver
16418.0,44,2,426.67,3,3,2,8,🔄 Moyen
16419.0,213,2,515.19,1,3,3,7,🔄 Moyen
16420.0,32,1,75.0,4,1,1,6,⚠️ À réactiver
16421.0,12,3,526.27,5,3,3,11,⭐ Fidèle
16422.0,5,72,27304.85,5,5,5,15,🏆 VIP
16424.0,18,1,309.5,4,1,2,7,🔄 Moyen
16428.0,49,3,660.28,3,3,3,9,🔄 Moyen
16430.0,17,6,817.09,4,4,3,11,⭐ Fidèle
16433.0,44,1,200.26,3,1,1,5,⚠️ À réactiver
16434.0,82,6,1204.79,2,4,4,10,⭐ Fidèle
16435.0,148,3,1011.5699999999999,2,3,4,9,🔄 Moyen
16436.0,304,4,242.04,1,4,2,7,🔄 Moyen
16437.0,17,2,301.25,4,3,2,9,🔄 Moyen
16439.0,358,1,310.7,1,1,2,4,⚠️ À réactiver
16440.0,129,1,216.3,2,1,1,4,⚠️ À réactiver
16441.0,53,4,642.28,3,4,3,10,⭐ Fidèle
16442.0,240,2,282.68,1,3,2,6,⚠️ À réactiver
16443.0,156,1,162.24,2,1,1,4,⚠️ À réactiver
16444.0,26,15,2943.61,4,5,5,14,🏆 VIP
16445.0,22,3,372.22,4,3,2,9,🔄 Moyen
16446.0,67,1,-9.0,3,1,1,5,⚠️ À réactiver
16447.0,226,2,516.13,1,3,3,7,🔄 Moyen
16448.0,107,1,178.98,2,1,1,4,⚠️ À réactiver
16450.0,220,3,1163.81,1,3,4,8,🔄 Moyen
16451.0,197,3,742.4300000000001,1,3,3,7,🔄 Moyen
16452.0,266,2,332.17,1,3,2,6,⚠️ À réactiver
16453.0,166,2,251.71,2,3,2,7,🔄 Moyen
16454.0,67,5,10.05,3,4,1,8,🔄 Moyen
16455.0,7,8,2465.54,5,5,5,15,🏆 VIP
16456.0,9,10,4027.04,5,5,5,15,🏆 VIP
16458.0,11,12,2232.6,5,5,5,15,🏆 VIP
16459.0,365,1,71.78999999999999,1,1,1,3,⚠️ À réactiver
16461.0,226,2,1463.8,1,3,4,8,🔄 Moyen
16465.0,49,3,726.34,3,3,3,9,🔄 Moyen
16466.0,19,9,2110.13,4,5,5,14,🏆 VIP
16467.0,144,8,2862.4,2,5,5,12,⭐ Fidèle
16468.0,106,2,712.62,2,3,3,8,🔄 Moyen
16469.0,150,1,178.48,2,1,1,4,⚠️ À réactiver
16470.0,32,7,1696.21,4,4,4,12,⭐ Fidèle
16471.0,28,5,962.23,4,4,4,12,⭐ Fidèle
16472.0,70,2,789.6,3,3,3,9,🔄 Moyen
16473.0,10,1,154.72,5,1,1,7,🔄 Moyen
16476.0,53,3,337.0,3,3,2,8,🔄 Moyen
16477.0,7,5,1825.56,5,4,4,13,🏆 VIP
16481.0,295,3,428.23,1,3,2,6,⚠️ À réactiver
16485.0,68,6,1774.03,3,4,4,11,⭐ Fidèle
16486.0,173,1,134.36,2,1,1,4,⚠️ À réactiver
16487.0,213,2,209.4,1,3,1,5,⚠️ À réactiver
16489.0,16,2,303.7,4,3,2,9,🔄 Moyen
16490.0,66,2,179.16,3,3,1,7,🔄 Moyen
16491.0,36,2,792.81,3,3,3,9,🔄 Moyen
16492.0,176,1,385.56,2,1,2,5,⚠️ À réactiver
16493.0,80,3,780.46,2,3,3,8,🔄 Moyen
16496.0,67,3,731.25,3,3,3,9,🔄 Moyen
16497.0,49,17,3729.59,3,5,5,13,🏆 VIP
16499.0,1,9,2172.64,5,5,5,15,🏆 VIP
16500.0,10,4,435.09999999999997,5,4,2,11,⭐ Fidèle
16501.0,19,1,1237.23,4,1,4,9,🔄 Moyen
16502.0,256,2,266.5,1,3,2,6,⚠️ À réactiver
16503.0,29,8,2176.46,4,5,5,14,🏆 VIP
16507.0,208,1,152.76,1,1,1,3,⚠️ À réactiver
16508.0,266,1,248.8,1,1,2,4,⚠️ À réactiver
16510.0,8,6,1851.8999999999999,5,4,4,13,🏆 VIP
16511.0,33,3,868.76,4,3,3,10,⭐ Fidèle
16512.0,364,1,-33.9,1,1,1,3,⚠️ À réactiver
16514.0,266,1,-134.86,1,1,1,3,⚠️ À réactiver
16515.0,15,5,1589.17,5,4,4,13,🏆 VIP
16518.0,57,3,457.34999999999997,3,3,2,8,🔄 Moyen
16519.0,1,3,341.18,5,3,2,10,⭐ Fidèle
16520.0,1,5,1429.3,5,4,4,13,🏆 VIP
16521.0,51,3,1148.01,3,3,4,10,⭐ Fidèle
16522.0,71,2,433.36,2,3,2,7,🔄 Moyen
16523.0,25,11,2464.87,4,5,5,14,🏆 VIP
16524.0,82,2,308.14,2,3,2,7,🔄 Moyen
16525.0,2,26,11455.17,5,5,5,15,🏆 VIP
16526.0,220,1,426.84999999999997,1,1,2,4,⚠️ À réactiver
16527.0,60,1,1044.38,3,1,4,8,🔄 Moyen
16529.0,113,3,1556.75,2,3,4,9,🔄 Moyen
16530.0,304,1,48.35,1,1,1,3,⚠️ À réactiver
16531.0,17,5,1018.99,4,4,4,12,⭐ Fidèle
16532.0,67,2,2007.8400000000001,3,3,4,10,⭐ Fidèle
16534.0,278,1,635.9,1,1,3,5,⚠️ À réactiver
16535.0,21,2,407.84,4,3,2,9,🔄 Moyen
16537.0,277,1,23.35,1,1,1,3,⚠️ À réactiver
16538.0,177,3,399.62,2,3,2,7,🔄 Moyen
16539.0,9,7,2343.2,5,4,5,14,🏆 VIP
16540.0,50,1,226.7,3,1,1,5,⚠️ À réactiver
16541.0,371,2,419.78,1,3,2,6,⚠️ À réactiver
16542.0,37,1,137.7,3,1,1,5,⚠️ À réactiver
16543.0,219,2,277.81,1,3,2,6,⚠️ À réactiver
16544.0,155,6,110.3,2,4,1,7,🔄 Moyen
16545.0,11,1,350.52,5,1,2,8,🔄 Moyen
16546.0,8,6,3933.29,5,4,5,14,🏆 VIP
16547.0,182,1,111.71,1,1,1,3,⚠️ À réactiver
16548.0,235,1,30.15,1,1,1,3,⚠️ À réactiver
16549.0,33,27,9005.0,4,5,5,14,🏆 VIP
16550.0,4,22,6903.07,5,5,5,15,🏆 VIP
16551.0,59,4,1315.0,3,4,4,11,⭐ Fidèle
16552.0,9,1,95.28999999999999,5,1,1,7,🔄 Moyen
16553.0,2,23,10891.3,5,5,5,15,🏆 VIP
16554.0,16,11,1765.62,4,5,4,13,🏆 VIP
16555.0,137,8,-8.881784197001252e-15,2,5,1,8,🔄 Moyen
16556.0,11,17,4296.44,5,5,5,15,🏆 VIP
16558.0,2,24,5461.92,5,5,5,15,🏆 VIP
16559.0,33,1,185.2,4,2,1,7,🔄 Moyen
16560.0,33,7,2194.22,4,4,5,13,🏆 VIP
16562.0,112,1,223.86,2,2,1,5,⚠️ À réactiver
16563.0,36,6,3334.82,3,4,5,12,⭐ Fidèle
16564.0,205,1,87.80000000000001,1,2,1,4,⚠️ À réactiver
16565.0,42,4,526.75,3,4,3,10,⭐ Fidèle
16568.0,63,2,1020.9,3,3,4,10,⭐ Fidèle
16569.0,267,4,1331.03,1,4,4,9,🔄 Moyen
16570.0,15,16,3218.87,5,5,5,15,🏆 VIP
16571.0,21,12,2739.83,4,5,5,14,🏆 VIP
16574.0,59,2,850.34,3,3,3,9,🔄 Moyen
16575.0,318,1,-10.49,1,2,1,4,⚠️ À réactiver
16576.0,45,5,513.17,3,4,3,10,⭐ Fidèle
16577.0,302,1,380.0,1,2,2,5,⚠️ À réactiver
16578.0,262,1,156.6,1,2,1,4,⚠️ À réactiver
16579.0,1,2,264.45,5,3,2,10,⭐ Fidèle
16580.0,364,1,-5.0,1,2,1,4,⚠️ À réactiver
16583.0,9,2,297.95,5,3,2,10,⭐ Fidèle
16584.0,64,4,2177.44,3,4,5,12,⭐ Fidèle
16585.0,229,2,341.59000000000003,1,3,2,6,⚠️ À réactiver
16586.0,80,2,998.8299999999999,2,3,4,9,🔄 Moyen
16588.0,22,4,1361.28,4,4,4,12,⭐ Fidèle
16589.0,86,1,153.12,2,2,1,5,⚠️ À réactiver
16590.0,17,3,563.6,4,3,3,10,⭐ Fidèle
16592.0,11,15,3551.18,5,5,5,15,🏆 VIP
16593.0,26,6,721.21,4,4,3,11,⭐ Fidèle
16595.0,12,4,1450.02,5,4,4,13,🏆 VIP
16596.0,2,3,329.48,5,3,2,10,⭐ Fidèle
16599.0,21,1,172.8,4,2,1,7,🔄 Moyen
16600.0,10,10,1280.04,5,5,4,14,🏆 VIP
16601.0,26,2,439.45,4,3,2,9,🔄 Moyen
16602.0,21,3,216.9,4,3,1,8,🔄 Moyen
16604.0,184,3,326.25,1,3,2,6,⚠️ À réactiver
16605.0,360,1,60.48,1,2,1,4,⚠️ À réactiver
16606.0,40,2,357.66,3,3,2,8,🔄 Moyen
16607.0,35,13,2336.5099999999998,4,5,5,14,🏆 VIP
16608.0,89,2,1288.72,2,3,4,9,🔄 Moyen
16611.0,39,5,1655.6399999999999,3,4,4,11,⭐ Fidèle
16612.0,10,6,2055.82,5,4,5,14,🏆 VIP
16614.0,38,2,673.6,3,3,3,9,🔄 Moyen
16615.0,204,2,264.5,1,3,2,6,⚠️ À réactiver
16619.0,19,3,1712.12,4,3,4,11,⭐ Fidèle
16620.0,25,4,1579.97,4,4,4,12,⭐ Fidèle
16622.0,178,2,205.6,1,3,1,5,⚠️ À réactiver
16623.0,37,4,873.04,3,4,3,10,⭐ Fidèle
16625.0,58,5,1318.0,3,4,4,11,⭐ Fidèle
16628.0,43,2,130.05,3,3,1,7,🔄 Moyen
16630.0,43,2,104.3,3,3,1,7,🔄 Moyen
16631.0,117,8,1867.02,2,5,4,11,⭐ Fidèle
16632.0,121,2,406.4,2,3,2,7,🔄 Moyen
16634.0,8,9,1145.2,5,5,4,14,🏆 VIP
16635.0,42,1,473.0,3,2,3,8,🔄 Moyen
16636.0,74,4,3802.04,2,4,5,11,⭐ Fidèle
16638.0,4,6,749.81,5,4,3,12,⭐ Fidèle
16639.0,45,1,490.47,3,2,3,8,🔄 Moyen
16640.0,33,1,179.4,4,2,1,7,🔄 Moyen
16641.0,337,1,323.4,1,2,2,5,⚠️ À réactiver
16642.0,24,2,371.63,4,3,2,9,🔄 Moyen
16643.0,53,2,428.05,3,3,2,8,🔄 Moyen
16645.0,371,1,160.39,1,2,1,4,⚠️ À réactiver
16646.0,79,2,675.05,2,3,3,8,🔄 Moyen
16647.0,78,2,327.84,2,3,2,7,🔄 Moyen
16648.0,91,2,382.14,2,3,2,7,🔄 Moyen
16649.0,156,1,306.58,2,2,2,6,⚠️ À réactiver
16650.0,56,6,1397.69,3,4,4,11,⭐ Fidèle
16651.0,222,1,136.2,1,2,1,4,⚠️ À réactiver
16652.0,40,13,10658.57,3,5,5,13,🏆 VIP
16654.0,4,5,1110.2,5,4,4,13,🏆 VIP
16655.0,47,8,2718.75,3,5,5,13,🏆 VIP
16656.0,56,23,7739.48,3,5,5,13,🏆 VIP
16658.0,4,9,573.48,5,5,3,13,🏆 VIP
16660.0,58,3,611.9,3,3,3,9,🔄 Moyen
16661.0,176,5,842.18,2,4,3,9,🔄 Moyen
16662.0,30,1,163.8,4,2,1,7,🔄 Moyen
16663.0,365,1,165.0,1,2,1,4,⚠️ À réactiver
16664.0,205,1,109.2,1,2,1,4,⚠️ À réactiver
16666.0,257,1,106.96,1,2,1,4,⚠️ À réactiver
16668.0,23,7,555.7,4,4,3,11,⭐ Fidèle
16669.0,262,1,-1144.73,1,2,1,4,⚠️ À réactiver
16670.0,29,16,3764.2,4,5,5,14,🏆 VIP
16673.0,315,1,188.82999999999998,1,2,1,4,⚠️ À réactiver
16675.0,77,2,608.86,2,3,3,8,🔄 Moyen
16676.0,38,2,769.78,3,3,3,9,🔄 Moyen
16677.0,29,3,849.77,4,3,3,10,⭐ Fidèle
16679.0,2,3,663.31,5,3,3,11,⭐ Fidèle
16680.0,164,2,637.75,2,3,3,8,🔄 Moyen
16681.0,277,1,151.5,1,2,1,4,⚠️ À réactiver
16683.0,165,2,309.35,2,3,2,7,🔄 Moyen
16684.0,15,34,75610.17,5,5,5,15,🏆 VIP
16686.0,25,9,2008.09,4,5,4,13,🏆 VIP
16687.0,26,1,157.63,4,2,1,7,🔄 Moyen
16690.0,29,2,127.45,4,3,1,8,🔄 Moyen
16691.0,54,2,178.82999999999998,3,3,1,7,🔄 Moyen
16692.0,44,2,638.7,3,3,3,9,🔄 Moyen
16693.0,47,3,717.45,3,3,3,9,🔄 Moyen
16694.0,359,1,98.3,1,2,1,4,⚠️ À réactiver
16695.0,197,2,193.15,1,3,1,5,⚠️ À réactiver
16699.0,16,8,964.9,4,5,4,13,🏆 VIP
16700.0,2,15,4044.06,5,5,5,15,🏆 VIP
16701.0,59,16,4464.32,3,5,5,13,🏆 VIP
16702.0,51,5,1100.8799999999999,3,4,4,11,⭐ Fidèle
16703.0,367,1,-15.0,1,2,1,4,⚠️ À réactiver
16704.0,254,2,695.66,1,3,3,7,🔄 Moyen
16705.0,24,32,28707.01,4,5,5,14,🏆 VIP
16707.0,36,4,551.11,3,4,3,10,⭐ Fidèle
16709.0,15,9,6057.59,5,5,5,15,🏆 VIP
16710.0,4,14,3853.3,5,5,5,15,🏆 VIP
16711.0,15,5,1100.45,5,4,4,13,🏆 VIP
16712.0,37,2,621.5600000000001,3,3,3,9,🔄 Moyen
16713.0,2,22,7540.31,5,5,5,15,🏆 VIP
16714.0,295,3,343.18,1,3,2,6,⚠️ À réactiver
16715.0,198,1,323.8,1,2,2,5,⚠️ À réactiver
16716.0,266,1,1248.48,1,2,4,7,🔄 Moyen
16717.0,2,12,3031.6,5,5,5,15,🏆 VIP
16718.0,5,5,3023.78,5,4,5,14,🏆 VIP
16719.0,4,10,2054.63,5,5,4,14,🏆 VIP
16720.0,12,3,438.19,5,3,2,10,⭐ Fidèle
16722.0,2,12,4256.62,5,5,5,15,🏆 VIP
16723.0,79,2,712.48,2,3,3,8,🔄 Moyen
16724.0,40,1,147.35,3,2,1,6,⚠️ À réactiver
16725.0,7,9,1095.64,5,5,4,14,🏆 VIP
16726.0,19,2,706.39,4,3,3,10,⭐ Fidèle
16727.0,28,3,1164.6,4,3,4,11,⭐ Fidèle
16731.0,284,1,174.05,1,2,1,4,⚠️ À réactiver
16732.0,32,8,3363.04,4,5,5,14,🏆 VIP
16733.0,165,1,259.68,2,2,2,6,⚠️ À réactiver
16735.0,29,15,3362.8,4,5,5,14,🏆 VIP
16736.0,141,8,2904.5099999999998,2,5,5,12,⭐ Fidèle
16737.0,213,1,417.6,1,2,2,5,⚠️ À réactiver
16739.0,149,2,459.68,2,3,2,7,🔄 Moyen
16740.0,31,1,236.81,4,2,2,8,🔄 Moyen
16741.0,261,1,173.06,1,2,1,4,⚠️ À réactiver
16742.0,128,13,2387.71,2,5,5,12,⭐ Fidèle
16743.0,92,7,2015.17,2,4,4,10,⭐ Fidèle
16746.0,19,27,11337.54,4,5,5,14,🏆 VIP
16748.0,24,10,2116.39,4,5,5,14,🏆 VIP
16749.0,227,2,4387.08,1,3,5,9,🔄 Moyen
16752.0,8,1,207.5,5,2,1,8,🔄 Moyen
16754.0,8,35,54558.18,5,5,5,15,🏆 VIP
16755.0,103,5,1397.4,2,4,4,10,⭐ Fidèle
16756.0,40,8,1048.02,3,5,4,12,⭐ Fidèle
16757.0,45,1,163.65,3,2,1,6,⚠️ À réactiver
16760.0,66,1,228.0,3,2,1,6,⚠️ À réactiver
16763.0,374,1,352.85,1,2,2,5,⚠️ À réactiver
16765.0,18,1,420.75,4,2,2,8,🔄 Moyen
16767.0,54,5,2391.2,3,4,5,12,⭐ Fidèle
16768.0,19,9,1189.03,4,5,4,13,🏆 VIP
16769.0,114,3,761.36,2,3,3,8,🔄 Moyen
16770.0,8,6,1155.1299999999999,5,4,4,13,🏆 VIP
16771.0,93,5,1720.79,2,4,4,10,⭐ Fidèle
16772.0,53,5,2785.6,3,4,5,12,⭐ Fidèle
16773.0,72,2,249.65,2,3,2,7,🔄 Moyen
16774.0,59,4,932.93,3,4,3,10,⭐ Fidèle
16775.0,3,7,1279.63,5,5,4,14,🏆 VIP
16776.0,51,1,231.57,3,2,2,7,🔄 Moyen
16777.0,36,4,1050.66,3,4,4,11,⭐ Fidèle
16779.0,2,35,22527.56,5,5,5,15,🏆 VIP
16780.0,43,1,180.36,3,2,1,6,⚠️ À réactiver
16781.0,1,3,606.4,5,3,3,11,⭐ Fidèle
16782.0,1,33,8106.71,5,5,5,15,🏆 VIP
16783.0,72,1,391.95,2,2,2,6,⚠️ À réactiver
16784.0,12,4,788.93,5,4,3,12,⭐ Fidèle
16785.0,45,1,533.78,3,2,3,8,🔄 Moyen
16786.0,29,1,51.84,4,2,1,7,🔄 Moyen
16787.0,33,4,1035.43,4,4,4,12,⭐ Fidèle
16788.0,40,3,1352.82,3,3,4,10,⭐ Fidèle
16791.0,16,10,2239.84,4,5,5,14,🏆 VIP
16792.0,19,3,513.08,4,3,3,10,⭐ Fidèle
16794.0,16,5,868.2,4,4,3,11,⭐ Fidèle
16795.0,1,5,2050.31,5,4,4,13,🏆 VIP
16797.0,29,9,1786.77,4,5,4,13,🏆 VIP
16798.0,190,4,837.56,1,4,3,8,🔄 Moyen
16799.0,68,3,491.03,3,3,3,9,🔄 Moyen
16802.0,315,2,582.61,1,3,3,7,🔄 Moyen
16805.0,213,3,636.65,1,3,3,7,🔄 Moyen
16807.0,106,5,943.29,2,4,4,10,⭐ Fidèle
16809.0,68,4,812.74,3,4,3,10,⭐ Fidèle
16810.0,50,2,510.5,3,3,3,9,🔄 Moyen
16812.0,14,4,1737.45,5,4,4,13,🏆 VIP
16814.0,5,16,5990.61,5,5,5,15,🏆 VIP
16815.0,89,2,410.97,2,3,2,7,🔄 Moyen
16817.0,1,7,1147.6,5,5,4,14,🏆 VIP
16819.0,101,2,182.59,2,3,1,6,⚠️ À réactiver
16821.0,17,1,113.35,4,2,1,7,🔄 Moyen
16822.0,299,3,144.84,1,3,1,5,⚠️ À réactiver
16823.0,23,7,1894.76,4,5,4,13,🏆 VIP
16824.0,29,1,225.6,4,2,1,7,🔄 Moyen
16825.0,14,3,1051.71,5,3,4,12,⭐ Fidèle
16827.0,29,5,392.13,4,4,2,10,⭐ Fidèle
16829.0,24,1,316.1,4,2,2,8,🔄 Moyen
16830.0,78,4,857.79,2,4,3,9,🔄 Moyen
16831.0,200,1,91.8,1,2,1,4,⚠️ À réactiver
16832.0,64,2,218.46,3,3,1,7,🔄 Moyen
16833.0,75,2,1302.51,2,3,4,9,🔄 Moyen
16834.0,310,1,485.5,1,2,3,6,⚠️ À réactiver
16835.0,9,9,1290.66,5,5,4,14,🏆 VIP
16836.0,42,2,530.5,3,3,3,9,🔄 Moyen
16838.0,166,3,543.76,2,3,3,8,🔄 Moyen
16839.0,5,13,5610.49,5,5,5,15,🏆 VIP
16840.0,239,3,126.71,1,3,1,5,⚠️ À réactiver
16841.0,64,7,2066.54,3,5,5,13,🏆 VIP
16843.0,58,21,9344.96,3,5,5,13,🏆 VIP
16844.0,198,2,614.34,1,3,3,7,🔄 Moyen
16845.0,254,1,253.88,1,2,2,5,⚠️ À réactiver
16846.0,213,2,628.09,1,3,3,7,🔄 Moyen
16847.0,254,1,421.45,1,2,2,5,⚠️ À réactiver
16848.0,12,3,1130.2,5,3,4,12,⭐ Fidèle
16853.0,367,1,-67.5,1,2,1,4,⚠️ À réactiver
16854.0,53,2,1408.96,3,3,4,10,⭐ Fidèle
16856.0,53,2,323.09,3,3,2,8,🔄 Moyen
16857.0,78,1,352.8,2,2,2,6,⚠️ À réactiver
16858.0,2,16,4085.74,5,5,5,15,🏆 VIP
16859.0,52,5,1184.6,3,4,4,11,⭐ Fidèle
16860.0,88,4,1593.67,2,4,4,10,⭐ Fidèle
16861.0,4,4,750.72,5,4,3,12,⭐ Fidèle
16862.0,183,4,662.3299999999999,1,4,3,8,🔄 Moyen
16863.0,2,2,495.71999999999997,5,3,3,11,⭐ Fidèle
16864.0,70,2,409.25,3,3,2,8,🔄 Moyen
16865.0,37,1,130.95,3,2,1,6,⚠️ À réactiver
16867.0,325,1,76.74,1,2,1,4,⚠️ À réactiver
16868.0,30,3,393.39,4,3,2,9,🔄 Moyen
16870.0,105,1,450.15999999999997,2,2,2,6,⚠️ À réactiver
16872.0,63,3,533.11,3,3,3,9,🔄 Moyen
16873.0,65,7,7480.72,3,5,5,13,🏆 VIP
16874.0,15,1,217.74,5,2,1,8,🔄 Moyen
16875.0,70,11,2029.73,3,5,4,12,⭐ Fidèle
16876.0,39,1,136.01,3,2,1,6,⚠️ À réactiver
16879.0,56,2,-140.95999999999998,3,3,1,7,🔄 Moyen
16880.0,129,1,321.78000000000003,2,2,2,6,⚠️ À réactiver
16883.0,7,19,2109.91,5,5,5,15,🏆 VIP
16884.0,192,2,644.08,1,3,3,7,🔄 Moyen
16885.0,21,1,239.23,4,2,2,8,🔄 Moyen
16886.0,80,2,0.0,2,3,1,6,⚠️ À réactiver
16887.0,36,2,465.84000000000003,3,3,2,8,🔄 Moyen
16888.0,36,3,437.15,3,3,2,8,🔄 Moyen
16889.0,33,3,952.23,4,3,4,11,⭐ Fidèle
16890.0,112,3,285.40999999999997,2,3,2,7,🔄 Moyen
16891.0,7,7,1247.1200000000001,5,5,4,14,🏆 VIP
16892.0,190,2,236.56,1,3,2,6,⚠️ À réactiver
16893.0,2,2,255.84,5,3,2,10,⭐ Fidèle
16894.0,138,5,1282.36,2,4,4,10,⭐ Fidèle
16895.0,74,4,902.28,2,4,3,9,🔄 Moyen
16896.0,191,1,103.95,1,2,1,4,⚠️ À réactiver
16898.0,1,4,443.21,5,4,2,11,⭐ Fidèle
16899.0,14,2,439.46,5,3,2,10,⭐ Fidèle
16901.0,365,1,204.26,1,2,1,4,⚠️ À réactiver
16903.0,16,3,656.74,4,3,3,10,⭐ Fidèle
16904.0,3,7,1378.1,5,5,4,14,🏆 VIP
16905.0,7,13,1919.02,5,5,4,14,🏆 VIP
16906.0,64,3,869.03,3,3,3,9,🔄 Moyen
16907.0,1,5,726.25,5,4,3,12,⭐ Fidèle
16908.0,358,2,153.59,1,3,1,5,⚠️ À réactiver
16911.0,263,3,251.35,1,3,2,6,⚠️ À réactiver
16912.0,57,4,1904.93,3,4,4,11,⭐ Fidèle
16913.0,287,2,310.47,1,3,2,6,⚠️ À réactiver
16915.0,22,5,921.5,4,4,3,11,⭐ Fidèle
16916.0,8,3,547.14,5,3,3,11,⭐ Fidèle
16917.0,268,2,1457.36,1,3,4,8,🔄 Moyen
16918.0,58,12,2094.72,3,5,5,13,🏆 VIP
16919.0,4,18,2457.36,5,5,5,15,🏆 VIP
16920.0,47,1,355.45,3,2,2,7,🔄 Moyen
16921.0,78,2,276.88,2,3,2,7,🔄 Moyen
16922.0,208,1,611.08,1,2,3,6,⚠️ À réactiver
16923.0,11,15,6126.55,5,5,5,15,🏆 VIP
16925.0,176,1,125.65,2,2,1,5,⚠️ À réactiver
16926.0,7,6,1180.15,5,4,4,13,🏆 VIP
16928.0,9,15,1212.08,5,5,4,14,🏆 VIP
16931.0,5,3,629.4,5,3,3,11,⭐ Fidèle
16932.0,59,2,278.77,3,3,2,8,🔄 Moyen
16933.0,25,11,2569.52,4,5,5,14,🏆 VIP
16934.0,19,5,1139.81,4,4,4,12,⭐ Fidèle
16935.0,17,3,535.1,4,3,3,10,⭐ Fidèle
16936.0,21,1,288.49,4,2,2,8,🔄 Moyen
16937.0,135,1,202.1,2,2,1,5,⚠️ À réactiver
16938.0,17,5,4306.8,4,4,5,13,🏆 VIP
16939.0,124,3,449.0,2,3,2,7,🔄 Moyen
16940.0,86,8,3195.53,2,5,5,12,⭐ Fidèle
16941.0,247,1,33.0,1,2,1,4,⚠️ À réactiver
16943.0,175,4,0.0,2,4,1,7,🔄 Moyen
16944.0,245,1,101.36,1,2,1,4,⚠️ À réactiver
16945.0,29,16,4185.16,4,5,5,14,🏆 VIP
16946.0,19,6,1199.54,4,4,4,12,⭐ Fidèle
16947.0,38,9,490.25,3,5,3,11,⭐ Fidèle
16948.0,65,4,433.75,3,4,2,9,🔄 Moyen
16950.0,3,10,2546.63,5,5,5,15,🏆 VIP
16952.0,77,3,631.17,2,3,3,8,🔄 Moyen
16954.0,15,12,3952.25,5,5,5,15,🏆 VIP
16955.0,4,6,767.49,5,4,3,12,⭐ Fidèle
16958.0,71,1,809.44,2,2,3,7,🔄 Moyen
16960.0,26,6,1514.93,4,4,4,12,⭐ Fidèle
16961.0,15,5,538.84,5,4,3,12,⭐ Fidèle
16962.0,45,1,251.04,3,2,2,7,🔄 Moyen
16964.0,369,2,207.85000000000002,1,3,1,5,⚠️ À réactiver
16970.0,262,1,71.4,1,2,1,4,⚠️ À réactiver
16972.0,18,2,786.25,4,3,3,10,⭐ Fidèle
16973.0,22,1,127.0,4,2,1,7,🔄 Moyen
16974.0,158,2,365.5,2,3,2,7,🔄 Moyen
16975.0,49,5,902.42,3,4,3,10,⭐ Fidèle
16977.0,31,4,496.0,4,4,3,11,⭐ Fidèle
16978.0,302,2,424.55,1,3,2,6,⚠️ À réactiver
16979.0,19,4,978.04,4,4,4,12,⭐ Fidèle
16980.0,64,1,394.37,3,2,2,7,🔄 Moyen
16981.0,176,1,-4620.86,2,2,1,5,⚠️ À réactiver
16983.0,5,5,1778.97,5,4,4,13,🏆 VIP
16984.0,35,14,6207.0,4,5,5,14,🏆 VIP
16985.0,12,15,5084.14,5,5,5,15,🏆 VIP
16986.0,81,9,3015.55,2,5,5,12,⭐ Fidèle
16987.0,12,5,898.95,5,4,3,12,⭐ Fidèle
16988.0,15,1,256.55,5,2,2,9,🔄 Moyen
16990.0,58,1,165.0,3,2,1,6,⚠️ À réactiver
16991.0,57,1,1041.21,3,2,4,9,🔄 Moyen
16992.0,23,9,3858.24,4,5,5,14,🏆 VIP
16993.0,99,3,1688.15,2,3,4,9,🔄 Moyen
16994.0,262,1,-779.32,1,2,1,4,⚠️ À réactiver
16995.0,8,1,-1.25,5,2,1,8,🔄 Moyen
16996.0,18,4,616.6999999999999,4,4,3,11,⭐ Fidèle
16998.0,80,1,107.0,2,2,1,5,⚠️ À réactiver
17000.0,32,2,406.3,4,3,2,9,🔄 Moyen
17001.0,12,8,2651.23,5,5,5,15,🏆 VIP
17002.0,79,4,1077.82,2,4,4,10,⭐ Fidèle
17003.0,38,4,830.16,3,4,3,10,⭐ Fidèle
17004.0,28,2,1012.22,4,3,4,11,⭐ Fidèle
17005.0,106,3,732.41,2,3,3,8,🔄 Moyen
17006.0,28,4,854.54,4,4,3,11,⭐ Fidèle
17007.0,73,1,230.17,2,2,1,5,⚠️ À réactiver
17008.0,65,1,81.36,3,2,1,6,⚠️ À réactiver
17009.0,187,1,242.06,1,2,2,5,⚠️ À réactiver
17011.0,283,3,265.8,1,3,2,6,⚠️ À réactiver
17012.0,361,1,384.16,1,2,2,5,⚠️ À réactiver
17013.0,239,2,-3224.76,1,3,1,5,⚠️ À réactiver
17016.0,212,1,552.4,1,2,3,6,⚠️ À réactiver
17017.0,1,18,-486.69999999999965,5,5,1,11,⭐ Fidèle
17018.0,23,4,1367.6,4,4,4,12,⭐ Fidèle
17019.0,4,10,2678.89,5,5,5,15,🏆 VIP
17020.0,178,2,935.62,1,3,3,7,🔄 Moyen
17021.0,78,6,1182.22,2,4,4,10,⭐ Fidèle
17022.0,68,1,189.0,3,2,1,6,⚠️ À réactiver
17023.0,53,3,800.18,3,3,3,9,🔄 Moyen
17025.0,9,4,1152.87,5,4,4,13,🏆 VIP
17026.0,5,2,54.15,5,3,1,9,🔄 Moyen
17027.0,82,3,436.82,2,3,2,7,🔄 Moyen
17028.0,217,3,1593.83,1,3,4,8,🔄 Moyen
17029.0,18,5,1421.3,4,4,4,12,⭐ Fidèle
17031.0,14,4,2393.5,5,4,5,14,🏆 VIP
17032.0,77,13,2150.06,2,5,5,12,⭐ Fidèle
17033.0,33,1,302.65,4,2,2,8,🔄 Moyen
17034.0,43,3,504.75,3,3,3,9,🔄 Moyen
17035.0,227,2,180.06,1,3,1,5,⚠️ À réactiver
17036.0,19,1,176.9,4,2,1,7,🔄 Moyen
17038.0,51,1,630.77,3,2,3,8,🔄 Moyen
17039.0,240,1,1954.99,1,2,4,7,🔄 Moyen
17040.0,186,1,13.52,1,2,1,4,⚠️ À réactiver
17041.0,33,3,604.71,4,3,3,10,⭐ Fidèle
17043.0,11,4,881.37,5,4,3,12,⭐ Fidèle
17044.0,10,13,10970.17,5,5,5,15,🏆 VIP
17045.0,12,2,488.24,5,3,3,11,⭐ Fidèle
17046.0,80,4,1264.05,2,4,4,10,⭐ Fidèle
17047.0,67,3,1188.33,3,3,4,10,⭐ Fidèle
17048.0,73,5,1127.1299999999999,2,4,4,10,⭐ Fidèle
17049.0,11,14,3999.0,5,5,5,15,🏆 VIP
17050.0,11,6,1162.82,5,4,4,13,🏆 VIP
17051.0,82,3,467.25,2,3,2,7,🔄 Moyen
17055.0,81,1,239.55,2,2,2,6,⚠️ À réactiver
17056.0,374,1,128.60000000000002,1,2,1,4,⚠️ À réactiver
17057.0,232,1,294.74,1,2,2,5,⚠️ À réactiver
17059.0,5,6,2489.79,5,4,5,14,🏆 VIP
17062.0,1,4,669.85,5,4,3,12,⭐ Fidèle
17063.0,15,12,2155.29,5,5,5,15,🏆 VIP
17065.0,273,2,194.7,1,3,1,5,⚠️ À réactiver
17066.0,362,1,228.34,1,2,1,4,⚠️ À réactiver
17067.0,360,3,454.53999999999996,1,3,2,6,⚠️ À réactiver
17068.0,4,28,4595.09,5,5,5,15,🏆 VIP
17069.0,9,9,3063.18,5,5,5,15,🏆 VIP
17070.0,46,1,133.18,3,2,1,6,⚠️ À réactiver
17071.0,15,6,1352.97,5,4,4,13,🏆 VIP
17072.0,261,1,282.05,1,2,2,5,⚠️ À réactiver
17074.0,198,1,203.05,1,2,1,4,⚠️ À réactiver
17075.0,65,6,1407.61,3,4,4,11,⭐ Fidèle
17076.0,28,3,401.67,4,3,2,9,🔄 Moyen
17077.0,214,1,306.0,1,2,2,5,⚠️ À réactiver
17080.0,15,5,669.91,5,4,3,12,⭐ Fidèle
17081.0,31,4,674.23,4,4,3,11,⭐ Fidèle
17082.0,30,4,2728.18,4,4,5,13,🏆 VIP
17083.0,38,8,2629.3,3,5,5,13,🏆 VIP
17084.0,32,2,2249.97,4,3,5,12,⭐ Fidèle
17085.0,12,26,6202.36,5,5,5,15,🏆 VIP
17087.0,373,1,221.53,1,2,1,4,⚠️ À réactiver
17089.0,22,1,128.45,4,2,1,7,🔄 Moyen
17090.0,10,7,1014.0899999999999,5,5,4,14,🏆 VIP
17091.0,3,14,3974.69,5,5,5,15,🏆 VIP
17092.0,73,10,3785.5299999999997,2,5,5,12,⭐ Fidèle
17093.0,228,1,235.88,1,2,2,5,⚠️ À réactiver
17094.0,59,1,100.2,3,2,1,6,⚠️ À réactiver
17095.0,60,6,1224.39,3,4,4,11,⭐ Fidèle
17096.0,16,10,2698.15,4,5,5,14,🏆 VIP
17097.0,1,2,386.03,5,3,2,10,⭐ Fidèle
17098.0,17,3,591.07,4,3,3,10,⭐ Fidèle
17099.0,169,1,582.17,2,2,3,7,🔄 Moyen
17101.0,30,3,885.3199999999999,4,3,3,10,⭐ Fidèle
17103.0,358,1,424.3,1,2,2,5,⚠️ À réactiver
17104.0,59,1,474.03000000000003,3,2,3,8,🔄 Moyen
17106.0,25,1,491.23,4,2,3,9,🔄 Moyen
17107.0,33,6,5236.39,4,4,5,13,🏆 VIP
17108.0,299,1,174.95,1,2,1,4,⚠️ À réactiver
17109.0,42,2,410.42,3,3,2,8,🔄 Moyen
17110.0,156,2,347.4,2,3,2,7,🔄 Moyen
17111.0,61,1,227.97,3,2,1,6,⚠️ À réactiver
17112.0,138,1,205.17000000000002,2,2,1,5,⚠️ À réactiver
17113.0,141,8,2109.16,2,5,5,12,⭐ Fidèle
17115.0,158,8,1809.39,2,5,4,11,⭐ Fidèle
17116.0,284,1,389.78,1,2,2,5,⚠️ À réactiver
17121.0,38,1,314.74,3,2,2,7,🔄 Moyen
17122.0,24,3,432.18,4,3,2,9,🔄 Moyen
17123.0,75,2,631.87,2,3,3,8,🔄 Moyen
17126.0,17,4,1065.69,4,4,4,12,⭐ Fidèle
17127.0,64,5,1155.03,3,4,4,11,⭐ Fidèle
17129.0,156,1,31.85,2,2,1,5,⚠️ À réactiver
17130.0,318,1,-18.38,1,2,1,4,⚠️ À réactiver
17132.0,88,2,1272.8,2,3,4,9,🔄 Moyen
17133.0,108,6,8079.849999999999,2,4,5,11,⭐ Fidèle
17134.0,78,1,212.1,2,2,1,5,⚠️ À réactiver
17135.0,7,5,803.51,5,4,3,12,⭐ Fidèle
17136.0,298,1,231.68,1,2,2,5,⚠️ À réactiver
17137.0,52,6,1133.63,3,4,4,11,⭐ Fidèle
17138.0,25,6,4036.77,4,4,5,13,🏆 VIP
17139.0,25,14,8906.04,4,5,5,14,🏆 VIP
17141.0,54,4,754.33,3,4,3,10,⭐ Fidèle
17142.0,40,3,704.75,3,3,3,9,🔄 Moyen
17143.0,53,2,924.11,3,3,3,9,🔄 Moyen
17145.0,101,7,3014.64,2,5,5,12,⭐ Fidèle
17146.0,66,13,5046.21,3,5,5,13,🏆 VIP
17147.0,49,10,1389.51,3,5,4,12,⭐ Fidèle
17149.0,87,1,143.10000000000002,2,2,1,5,⚠️ À réactiver
17150.0,12,6,1375.65,5,4,4,13,🏆 VIP
17151.0,371,1,231.90000000000003,1,2,2,5,⚠️ À réactiver
17152.0,61,1,327.0,3,2,2,7,🔄 Moyen
17155.0,163,5,640.76,2,4,3,9,🔄 Moyen
17156.0,120,2,572.0699999999999,2,3,3,8,🔄 Moyen
17157.0,116,17,4832.900000000001,2,5,5,12,⭐ Fidèle
17158.0,183,3,695.33,1,3,3,7,🔄 Moyen
17159.0,113,2,560.71,2,3,3,8,🔄 Moyen
17160.0,10,12,6683.33,5,5,5,15,🏆 VIP
17161.0,80,1,856.01,2,2,3,7,🔄 Moyen
17163.0,81,2,406.68,2,3,2,7,🔄 Moyen
17165.0,17,7,1624.95,4,5,4,13,🏆 VIP
17167.0,15,3,867.11,5,3,3,11,⭐ Fidèle
17168.0,134,1,400.2,2,2,2,6,⚠️ À réactiver
17169.0,196,2,313.0,1,3,2,6,⚠️ À réactiver
17170.0,10,3,118.98,5,3,1,9,🔄 Moyen
17171.0,297,1,159.68,1,2,1,4,⚠️ À réactiver
17172.0,63,4,597.73,3,4,3,10,⭐ Fidèle
17176.0,162,2,596.1899999999999,2,3,3,8,🔄 Moyen
17177.0,141,1,119.5,2,2,1,5,⚠️ À réactiver
17178.0,367,1,436.71000000000004,1,2,2,5,⚠️ À réactiver
17179.0,18,3,795.47,4,3,3,10,⭐ Fidèle
17180.0,58,8,1455.95,3,5,4,12,⭐ Fidèle
17181.0,9,2,225.45,5,3,1,9,🔄 Moyen
17182.0,58,2,321.3,3,3,2,8,🔄 Moyen
17184.0,205,2,198.41,1,3,1,5,⚠️ À réactiver
17185.0,227,3,229.46,1,3,1,5,⚠️ À réactiver
17187.0,162,1,263.76,2,2,2,6,⚠️ À réactiver
17188.0,71,8,2086.25,2,5,5,12,⭐ Fidèle
17189.0,196,3,573.23,1,3,3,7,🔄 Moyen
17190.0,39,5,1298.3,3,4,4,11,⭐ Fidèle
17191.0,4,12,2715.42,5,5,5,15,🏆 VIP
17192.0,172,1,77.83,2,2,1,5,⚠️ À réactiver
17193.0,22,3,580.14,4,3,3,10,⭐ Fidèle
17194.0,166,1,549.88,2,2,3,7,🔄 Moyen
17195.0,291,1,562.98,1,2,3,6,⚠️ À réactiver
17196.0,63,1,352.9,3,2,2,7,🔄 Moyen
17198.0,1,2,521.66,5,3,3,11,⭐ Fidèle
17199.0,218,1,145.12,1,2,1,4,⚠️ À réactiver
17200.0,23,4,356.71,4,4,2,10,⭐ Fidèle
17201.0,159,4,883.81,2,4,3,9,🔄 Moyen
17202.0,56,1,160.65,3,2,1,6,⚠️ À réactiver
17203.0,24,4,2012.03,4,4,4,12,⭐ Fidèle
17204.0,10,6,3910.78,5,4,5,14,🏆 VIP
17205.0,52,2,615.27,3,3,3,9,🔄 Moyen
17207.0,288,1,303.21999999999997,1,2,2,5,⚠️ À réactiver
17208.0,31,1,115.35,4,2,1,7,🔄 Moyen
17209.0,285,3,611.6,1,3,3,7,🔄 Moyen
17210.0,28,1,253.37,4,2,2,8,🔄 Moyen
17211.0,5,7,1702.43,5,5,4,14,🏆 VIP
17212.0,94,2,567.56,2,3,3,8,🔄 Moyen
17213.0,2,10,2337.85,5,5,5,15,🏆 VIP
17215.0,100,1,186.15,2,2,1,5,⚠️ À réactiver
17216.0,190,1,65.05,1,2,1,4,⚠️ À réactiver
17217.0,255,1,104.5,1,2,1,4,⚠️ À réactiver
17218.0,4,9,2231.96,5,5,5,15,🏆 VIP
17219.0,52,1,144.9,3,2,1,6,⚠️ À réactiver
17220.0,53,7,1283.5,3,5,4,12,⭐ Fidèle
17221.0,227,3,643.39,1,3,3,7,🔄 Moyen
17222.0,113,5,1250.86,2,4,4,10,⭐ Fidèle
17223.0,4,2,446.74,5,3,2,10,⭐ Fidèle
17224.0,137,1,100.86000000000001,2,2,1,5,⚠️ À réactiver
17225.0,217,1,131.15,1,2,1,4,⚠️ À réactiver
17226.0,80,2,506.63,2,3,3,8,🔄 Moyen
17227.0,4,7,1082.71,5,5,4,14,🏆 VIP
17228.0,3,7,1271.15,5,5,4,14,🏆 VIP
17230.0,198,12,6229.24,1,5,5,11,⭐ Fidèle
17231.0,25,21,3963.25,4,5,5,14,🏆 VIP
17233.0,84,2,369.98,2,3,2,7,🔄 Moyen
17235.0,8,7,1354.82,5,5,4,14,🏆 VIP
17236.0,46,6,1013.13,3,4,4,11,⭐ Fidèle
17237.0,11,2,687.39,5,3,3,11,⭐ Fidèle
17238.0,7,17,4038.45,5,5,5,15,🏆 VIP
17239.0,23,4,794.2,4,4,3,11,⭐ Fidèle
17240.0,232,1,130.6,1,2,1,4,⚠️ À réactiver
17241.0,21,12,2744.14,4,5,5,14,🏆 VIP
17242.0,92,3,1754.24,2,3,4,9,🔄 Moyen
17243.0,5,51,12080.66,5,5,5,15,🏆 VIP
17244.0,19,4,871.14,4,4,3,11,⭐ Fidèle
17245.0,325,1,200.18,1,2,1,4,⚠️ À réactiver
17246.0,182,2,38.92,1,3,1,5,⚠️ À réactiver
17248.0,117,1,227.51,2,2,1,5,⚠️ À réactiver
17249.0,64,1,68.03,3,2,1,6,⚠️ À réactiver
17251.0,18,3,520.45,4,3,3,10,⭐ Fidèle
17254.0,37,1,198.29,3,2,1,6,⚠️ À réactiver
17255.0,26,2,500.71999999999997,4,3,3,10,⭐ Fidèle
17256.0,117,3,258.93,2,3,2,7,🔄 Moyen
17257.0,72,2,192.73,2,3,1,6,⚠️ À réactiver
17258.0,32,2,417.3,4,3,2,9,🔄 Moyen
17259.0,4,5,1285.97,5,4,4,13,🏆 VIP
17260.0,47,1,120.95,3,2,1,6,⚠️ À réactiver
17261.0,145,1,230.44,2,2,1,5,⚠️ À réactiver
17262.0,2,7,1504.26,5,5,4,14,🏆 VIP
17264.0,60,1,279.59,3,2,2,7,🔄 Moyen
17266.0,135,2,207.09,2,3,1,6,⚠️ À réactiver
17268.0,81,7,970.25,2,5,4,11,⭐ Fidèle
17269.0,21,1,537.46,4,2,3,9,🔄 Moyen
17270.0,105,2,604.4,2,3,3,8,🔄 Moyen
17271.0,372,1,210.39,1,2,1,4,⚠️ À réactiver
17273.0,60,1,141.12,3,2,1,6,⚠️ À réactiver
17274.0,31,1,465.4,4,2,2,8,🔄 Moyen
17275.0,19,1,114.52,4,2,1,7,🔄 Moyen
17276.0,35,2,451.34000000000003,4,3,2,9,🔄 Moyen
17278.0,201,1,25.2,1,2,1,4,⚠️ À réactiver
17280.0,74,1,118.86,2,2,1,5,⚠️ À réactiver
17281.0,10,6,797.85,5,4,3,12,⭐ Fidèle
17282.0,92,2,636.25,2,3,3,8,🔄 Moyen
17283.0,14,1,188.46,5,2,1,8,🔄 Moyen
17284.0,25,4,686.54,4,4,3,11,⭐ Fidèle
17285.0,264,2,428.34,1,3,2,6,⚠️ À réactiver
17286.0,36,2,241.56,3,3,2,8,🔄 Moyen
17287.0,3,18,3031.6,5,5,5,15,🏆 VIP
17288.0,26,4,1080.25,4,4,4,12,⭐ Fidèle
17289.0,12,7,1133.73,5,5,4,14,🏆 VIP
17290.0,17,6,976.2,4,4,4,12,⭐ Fidèle
17292.0,108,2,271.75,2,3,2,7,🔄 Moyen
17293.0,30,8,1899.12,4,5,4,13,🏆 VIP
17294.0,305,2,467.79,1,3,2,6,⚠️ À réactiver
17296.0,366,1,338.13,1,2,2,5,⚠️ À réactiver
17298.0,10,4,454.1,5,4,2,11,⭐ Fidèle
17299.0,75,2,346.97,2,3,2,7,🔄 Moyen
17300.0,26,2,393.64,4,3,2,9,🔄 Moyen
17301.0,260,1,132.8,1,2,1,4,⚠️ À réactiver
17304.0,170,1,111.5,2,2,1,5,⚠️ À réactiver
17305.0,284,1,2135.46,1,2,5,8,🔄 Moyen
17306.0,29,2,1151.04,4,3,4,11,⭐ Fidèle
17307.0,1,15,3378.31,5,5,5,15,🏆 VIP
17308.0,29,2,4511.76,4,3,5,12,⭐ Fidèle
17309.0,17,2,247.84,4,3,2,9,🔄 Moyen
17310.0,23,2,1025.1,4,3,4,11,⭐ Fidèle
17311.0,28,5,2105.81,4,4,5,13,🏆 VIP
17314.0,29,11,1999.94,4,5,4,13,🏆 VIP
17315.0,11,6,3354.09,5,4,5,14,🏆 VIP
17316.0,56,1,124.45,3,2,1,6,⚠️ À réactiver
17318.0,361,1,164.28,1,2,1,4,⚠️ À réactiver
17319.0,305,1,29.099999999999998,1,2,1,4,⚠️ À réactiver
17320.0,4,4,1695.15,5,4,4,13,🏆 VIP
17321.0,30,4,1040.32,4,4,4,12,⭐ Fidèle
17322.0,12,7,900.64,5,5,3,13,🏆 VIP
17323.0,43,5,644.52,3,4,3,10,⭐ Fidèle
17324.0,2,10,1158.64,5,5,4,14,🏆 VIP
17325.0,46,2,512.77,3,3,3,9,🔄 Moyen
17326.0,44,2,321.95,3,3,2,8,🔄 Moyen
17327.0,45,2,152.35,3,3,1,7,🔄 Moyen
17328.0,309,1,104.7,1,2,1,4,⚠️ À réactiver
17329.0,367,3,481.32,1,3,3,7,🔄 Moyen
17330.0,180,2,59.900000000000006,1,3,1,5,⚠️ À réactiver
17332.0,164,5,838.27,2,4,3,9,🔄 Moyen
17334.0,42,1,328.13,3,2,2,7,🔄 Moyen
17335.0,19,2,508.0,4,3,3,10,⭐ Fidèle
17336.0,108,1,81.12,2,2,1,5,⚠️ À réactiver
17338.0,11,10,5424.39,5,5,5,15,🏆 VIP
17339.0,1,3,60.0,5,3,1,9,🔄 Moyen
17340.0,2,16,9520.46,5,5,5,15,🏆 VIP
17341.0,2,3,1108.47,5,3,4,12,⭐ Fidèle
17342.0,10,7,1155.84,5,5,4,14,🏆 VIP
17343.0,12,5,1066.3,5,4,4,13,🏆 VIP
17344.0,364,2,294.04,1,3,2,6,⚠️ À réactiver
17345.0,11,8,946.64,5,5,4,14,🏆 VIP
17346.0,9,12,2646.44,5,5,5,15,🏆 VIP
17348.0,73,4,1316.89,2,4,4,10,⭐ Fidèle
17349.0,16,4,741.5,4,4,3,11,⭐ Fidèle
17350.0,30,3,619.97,4,3,3,10,⭐ Fidèle
17351.0,63,9,1401.08,3,5,4,12,⭐ Fidèle
17352.0,332,1,36.25,1,2,1,4,⚠️ À réactiver
17353.0,49,5,1415.55,3,4,4,11,⭐ Fidèle
17354.0,64,3,1750.4,3,3,4,10,⭐ Fidèle
17355.0,22,1,285.11,4,2,2,8,🔄 Moyen
17356.0,190,4,768.25,1,4,3,8,🔄 Moyen
17358.0,12,3,500.2,5,3,3,11,⭐ Fidèle
17359.0,284,1,156.6,1,2,1,4,⚠️ À réactiver
17360.0,21,4,615.64,4,4,3,11,⭐ Fidèle
17361.0,312,2,392.44,1,3,2,6,⚠️ À réactiver
17362.0,36,6,698.31,3,4,3,10,⭐ Fidèle
17363.0,31,3,940.86,4,3,4,11,⭐ Fidèle
17364.0,12,19,7228.82,5,5,5,15,🏆 VIP
17365.0,22,8,3404.27,4,5,5,14,🏆 VIP
17366.0,28,3,1094.59,4,3,4,11,⭐ Fidèle
17368.0,11,7,863.72,5,5,3,13,🏆 VIP
17369.0,91,1,979.2,2,2,4,8,🔄 Moyen
17371.0,259,3,238.66,1,3,2,6,⚠️ À réactiver
17372.0,17,23,2982.75,4,5,5,14,🏆 VIP
17373.0,54,3,520.58,3,3,3,9,🔄 Moyen
17374.0,29,2,215.44,4,3,1,8,🔄 Moyen
17375.0,67,1,260.45,3,2,2,7,🔄 Moyen
17376.0,40,2,250.44,3,3,2,8,🔄 Moyen
17377.0,1,72,13925.49,5,5,5,15,🏆 VIP
17378.0,10,2,0.0,5,3,1,9,🔄 Moyen
17380.0,70,4,643.75,3,4,3,10,⭐ Fidèle
17381.0,4,12,19726.76,5,5,5,15,🏆 VIP
17382.0,71,7,836.88,2,5,3,10,⭐ Fidèle
17383.0,89,1,110.7,2,2,1,5,⚠️ À réactiver
17384.0,103,1,171.15,2,2,1,5,⚠️ À réactiver
17386.0,21,1,126.35000000000001,4,2,1,7,🔄 Moyen
17388.0,56,7,1432.01,3,5,4,12,⭐ Fidèle
17389.0,10,34,23286.95,5,5,5,15,🏆 VIP
17390.0,56,1,149.3,3,2,1,6,⚠️ À réactiver
17392.0,86,1,168.65,2,2,1,5,⚠️ À réactiver
17393.0,46,2,381.15000000000003,3,3,2,8,🔄 Moyen
17395.0,144,1,97.5,2,2,1,5,⚠️ À réactiver
17396.0,7,9,1198.8,5,5,4,14,🏆 VIP
17397.0,52,1,536.77,3,2,3,8,🔄 Moyen
17399.0,176,1,-25111.09,2,2,1,5,⚠️ À réactiver
17400.0,217,3,2547.09,1,3,5,9,🔄 Moyen
17401.0,177,1,114.85,2,2,1,5,⚠️ À réactiver
17402.0,5,15,2413.23,5,5,5,15,🏆 VIP
17403.0,86,1,118.95,2,2,1,5,⚠️ À réactiver
17404.0,35,10,15706.0,4,5,5,14,🏆 VIP
17406.0,2,14,2663.38,5,5,5,15,🏆 VIP
17407.0,47,1,552.9,3,2,3,8,🔄 Moyen
17408.0,136,3,132.24,2,3,1,6,⚠️ À réactiver
17409.0,57,8,7021.66,3,5,5,13,🏆 VIP
17411.0,1,6,537.59,5,4,3,12,⭐ Fidèle
17412.0,8,13,3126.92,5,5,5,15,🏆 VIP
17413.0,40,2,560.14,3,3,3,9,🔄 Moyen
17414.0,59,4,1471.52,3,4,4,11,⭐ Fidèle
17416.0,29,16,10383.13,4,5,5,14,🏆 VIP
17417.0,184,1,164.18,1,2,1,4,⚠️ À réactiver
17418.0,23,1,206.6,4,2,1,7,🔄 Moyen
17419.0,3,8,2273.95,5,5,5,15,🏆 VIP
17420.0,9,6,475.7,5,4,3,12,⭐ Fidèle
17421.0,22,3,1059.41,4,3,4,11,⭐ Fidèle
17422.0,10,10,1488.52,5,5,4,14,🏆 VIP
17423.0,29,1,420.54,4,2,2,8,🔄 Moyen
17424.0,64,1,-176.96,3,2,1,6,⚠️ À réactiver
17426.0,88,10,2584.11,2,5,5,12,⭐ Fidèle
17428.0,4,19,14159.61,5,5,5,15,🏆 VIP
17429.0,32,3,830.04,4,3,3,10,⭐ Fidèle
17430.0,1,3,469.40999999999997,5,3,2,10,⭐ Fidèle
17432.0,21,7,1385.6299999999999,4,5,4,13,🏆 VIP
17433.0,21,1,266.8,4,2,2,8,🔄 Moyen
17435.0,47,1,331.34999999999997,3,2,2,7,🔄 Moyen
17436.0,44,5,305.01,3,4,2,9,🔄 Moyen
17437.0,165,1,373.17,2,2,2,6,⚠️ À réactiver
17438.0,80,4,1034.32,2,4,4,10,⭐ Fidèle
17439.0,291,1,325.74,1,2,2,5,⚠️ À réactiver
17440.0,185,1,137.16,1,2,1,4,⚠️ À réactiver
17441.0,368,1,293.34999999999997,1,2,2,5,⚠️ À réactiver
17442.0,1,14,2290.44,5,5,5,15,🏆 VIP
17445.0,266,1,-506.51,1,2,1,4,⚠️ À réactiver
17448.0,133,53,14480.36,2,5,5,12,⭐ Fidèle
17449.0,23,6,2430.29,4,4,5,13,🏆 VIP
17450.0,3,8,46097.22,5,5,5,15,🏆 VIP
17452.0,239,1,-227.28,1,2,1,4,⚠️ À réactiver
17454.0,88,7,1015.11,2,5,4,11,⭐ Fidèle
17456.0,1,2,975.56,5,3,4,12,⭐ Fidèle
17457.0,15,13,4061.31,5,5,5,15,🏆 VIP
17458.0,17,1,213.08,4,2,1,7,🔄 Moyen
17460.0,8,15,1554.77,5,5,4,14,🏆 VIP
17463.0,192,3,656.55,1,3,3,7,🔄 Moyen
17464.0,158,3,589.7800000000001,2,3,3,8,🔄 Moyen
17465.0,61,9,2533.64,3,5,5,13,🏆 VIP
17467.0,31,1,102.6,4,2,1,7,🔄 Moyen
17468.0,11,1,57.8,5,2,1,8,🔄 Moyen
17469.0,36,16,3115.2799999999997,3,5,5,13,🏆 VIP
17470.0,3,7,1679.8,5,5,4,14,🏆 VIP
17471.0,110,1,321.65,2,2,2,6,⚠️ À réactiver
17472.0,264,1,224.81,1,2,1,4,⚠️ À réactiver
17473.0,37,3,592.15,3,3,3,9,🔄 Moyen
17474.0,235,1,1047.0,1,2,4,7,🔄 Moyen
17476.0,29,4,446.51,4,4,2,10,⭐ Fidèle
17477.0,248,5,1079.0,1,4,4,9,🔄 Moyen
17478.0,44,2,1272.8,3,3,4,10,⭐ Fidèle
17479.0,268,1,389.26,1,2,2,5,⚠️ À réactiver
17480.0,80,1,390.21,2,2,2,6,⚠️ À réactiver
17482.0,123,2,778.19,2,3,3,8,🔄 Moyen
17483.0,50,1,177.69,3,2,1,6,⚠️ À réactiver
17484.0,212,2,209.57,1,3,1,5,⚠️ À réactiver
17485.0,374,1,-29.55,1,2,1,4,⚠️ À réactiver
17487.0,364,1,160.55,1,2,1,4,⚠️ À réactiver
17488.0,277,1,336.5,1,2,2,5,⚠️ À réactiver
17490.0,24,2,658.18,4,3,3,10,⭐ Fidèle
17491.0,3,8,2422.2,5,5,5,15,🏆 VIP
17492.0,114,2,747.85,2,3,3,8,🔄 Moyen
17493.0,21,1,100.91,4,2,1,7,🔄 Moyen
17494.0,137,1,54.7,2,2,1,5,⚠️ À réactiver
17495.0,21,2,261.51,4,3,2,9,🔄 Moyen
17496.0,199,4,1114.84,1,4,4,9,🔄 Moyen
17497.0,26,2,287.25,4,3,2,9,🔄 Moyen
17499.0,183,2,673.96,1,3,3,7,🔄 Moyen
17504.0,16,9,6568.09,4,5,5,14,🏆 VIP
17505.0,186,3,1289.6399999999999,1,3,4,8,🔄 Moyen
17508.0,17,8,4159.47,4,5,5,14,🏆 VIP
17510.0,56,1,206.07999999999998,3,2,1,6,⚠️ À réactiver
17511.0,3,42,83760.6,5,5,5,15,🏆 VIP
17512.0,88,9,2512.23,2,5,5,12,⭐ Fidèle
17513.0,44,2,645.6,3,3,3,9,🔄 Moyen
17514.0,305,1,334.18,1,2,2,5,⚠️ À réactiver
17515.0,30,5,978.4399999999999,4,4,4,12,⭐ Fidèle
17516.0,14,1,189.47,5,2,1,8,🔄 Moyen
17518.0,61,2,329.42,3,3,2,8,🔄 Moyen
17519.0,4,11,3263.73,5,5,5,15,🏆 VIP
17521.0,30,2,554.85,4,3,3,10,⭐ Fidèle
17524.0,74,3,363.9,2,3,2,7,🔄 Moyen
17525.0,33,2,739.1999999999999,4,3,3,10,⭐ Fidèle
17526.0,1,9,2970.14,5,5,5,15,🏆 VIP
17529.0,246,2,1240.25,1,3,4,8,🔄 Moyen
17530.0,1,4,755.5600000000001,5,4,3,12,⭐ Fidèle
17531.0,147,7,897.77,2,5,3,10,⭐ Fidèle
17532.0,21,1,65.34,4,2,1,7,🔄 Moyen
17533.0,70,1,34.8,3,2,1,6,⚠️ À réactiver
17534.0,87,4,1445.47,2,4,4,10,⭐ Fidèle
17536.0,56,2,288.33,3,3,2,8,🔄 Moyen
17539.0,253,7,1047.07,1,5,4,10,⭐ Fidèle
17540.0,19,4,1011.6999999999999,4,4,4,12,⭐ Fidèle
17541.0,145,1,124.46,2,2,1,5,⚠️ À réactiver
17542.0,277,2,170.95,1,3,1,5,⚠️ À réactiver
17543.0,185,1,120.05,1,2,1,4,⚠️ À réactiver
17544.0,26,3,960.6899999999999,4,3,4,11,⭐ Fidèle
17545.0,26,3,802.58,4,3,3,10,⭐ Fidèle
17546.0,182,1,-648.05,1,2,1,4,⚠️ À réactiver
17547.0,8,4,692.35,5,4,3,12,⭐ Fidèle
17548.0,9,4,486.48,5,4,3,12,⭐ Fidèle
17550.0,33,7,1939.38,4,5,4,13,🏆 VIP
17552.0,8,12,2129.24,5,5,5,15,🏆 VIP
17553.0,108,3,2270.0,2,3,5,10,⭐ Fidèle
17555.0,61,3,574.48,3,3,3,9,🔄 Moyen
17556.0,15,1,142.76999999999998,5,2,1,8,🔄 Moyen
17557.0,368,1,34.0,1,2,1,4,⚠️ À réactiver
17558.0,29,1,259.17,4,2,2,8,🔄 Moyen
17559.0,148,1,167.62,2,2,1,5,⚠️ À réactiver
17560.0,31,4,1040.85,4,4,4,12,⭐ Fidèle
17561.0,26,3,554.72,4,3,3,10,⭐ Fidèle
17563.0,214,5,309.28,1,4,2,7,🔄 Moyen
17565.0,222,1,131.83,1,2,1,4,⚠️ À réactiver
17567.0,8,2,1024.55,5,3,4,12,⭐ Fidèle
17568.0,269,1,382.79,1,2,2,5,⚠️ À réactiver
17570.0,17,2,0.0,4,3,1,8,🔄 Moyen
17571.0,178,1,205.24,1,2,1,4,⚠️ À réactiver
17572.0,9,7,496.26,5,5,3,13,🏆 VIP
17575.0,303,1,171.7,1,2,1,4,⚠️ À réactiver
17576.0,1,24,5427.88,5,5,5,15,🏆 VIP
17577.0,281,2,348.75,1,3,2,6,⚠️ À réactiver
17578.0,110,8,878.99,2,5,3,10,⭐ Fidèle
17579.0,214,1,304.38,1,2,2,5,⚠️ À réactiver
17580.0,12,2,329.55,5,3,2,10,⭐ Fidèle
17581.0,8,24,7511.36,5,5,5,15,🏆 VIP
17582.0,82,5,1258.43,2,4,4,10,⭐ Fidèle
17583.0,196,1,135.95,1,2,1,4,⚠️ À réactiver
17584.0,103,4,4067.12,2,4,5,11,⭐ Fidèle
17585.0,81,3,960.23,2,3,4,9,🔄 Moyen
17586.0,255,1,167.4,1,2,1,4,⚠️ À réactiver
17587.0,264,1,181.66,1,2,1,4,⚠️ À réactiver
17588.0,32,6,1661.45,4,4,4,12,⭐ Fidèle
17589.0,21,17,11500.65,4,5,5,14,🏆 VIP
17591.0,3,2,550.7,5,3,3,11,⭐ Fidèle
17592.0,374,2,0.0,1,3,1,5,⚠️ À réactiver
17593.0,45,9,4132.44,3,5,5,13,🏆 VIP
17594.0,85,2,1504.7,2,3,4,9,🔄 Moyen
17596.0,4,8,2079.39,5,5,5,15,🏆 VIP
17597.0,45,6,1380.92,3,4,4,11,⭐ Fidèle
17598.0,17,1,409.98,4,2,2,8,🔄 Moyen
17599.0,100,3,44.55,2,3,1,6,⚠️ À réactiver
17601.0,16,1,305.46999999999997,4,2,2,8,🔄 Moyen
17602.0,100,10,2286.66,2,5,5,12,⭐ Fidèle
17603.0,253,6,1285.31,1,4,4,9,🔄 Moyen
17604.0,58,4,636.57,3,4,3,10,⭐ Fidèle
17605.0,226,1,160.75,1,2,1,4,⚠️ À réactiver
17606.0,373,1,87.3,1,2,1,4,⚠️ À réactiver
17607.0,12,1,333.81,5,2,2,9,🔄 Moyen
17608.0,85,2,305.11,2,3,2,7,🔄 Moyen
17609.0,38,8,655.0699999999999,3,5,3,11,⭐ Fidèle
17610.0,176,8,1427.84,2,5,4,11,⭐ Fidèle
17611.0,57,16,4257.51,3,5,5,13,🏆 VIP
17612.0,10,22,3163.38,5,5,5,15,🏆 VIP
17615.0,23,4,396.1,4,4,2,10,⭐ Fidèle
17616.0,3,2,489.59999999999997,5,3,3,11,⭐ Fidèle
17617.0,194,2,237.28,1,3,2,6,⚠️ À réactiver
17618.0,19,10,3076.36,4,5,5,14,🏆 VIP
17621.0,21,4,1693.22,4,4,4,12,⭐ Fidèle
17622.0,232,3,1125.17,1,3,4,8,🔄 Moyen
17623.0,45,6,1856.62,3,4,4,11,⭐ Fidèle
17624.0,73,2,725.15,2,3,3,8,🔄 Moyen
17625.0,82,4,4020.8,2,4,5,11,⭐ Fidèle
17626.0,238,1,254.0,1,2,2,5,⚠️ À réactiver
17627.0,114,2,285.11,2,3,2,7,🔄 Moyen
17629.0,24,2,641.4,4,3,3,10,⭐ Fidèle
17631.0,10,4,470.15999999999997,5,4,2,11,⭐ Fidèle
17632.0,353,2,-12.7,1,3,1,5,⚠️ À réactiver
17633.0,15,3,732.55,5,3,3,11,⭐ Fidèle
17635.0,60,4,1256.83,3,4,4,11,⭐ Fidèle
17638.0,283,2,842.4000000000001,1,3,3,7,🔄 Moyen
17639.0,23,5,506.67,4,4,3,11,⭐ Fidèle
17640.0,15,7,2485.93,5,5,5,15,🏆 VIP
17641.0,374,1,-6.95,1,2,1,4,⚠️ À réactiver
17642.0,65,3,1112.2,3,3,4,10,⭐ Fidèle
17643.0,9,2,439.7,5,3,2,10,⭐ Fidèle
17644.0,30,11,3095.56,4,5,5,14,🏆 VIP
17645.0,364,1,-9.9,1,2,1,4,⚠️ À réactiver
17646.0,1,13,3098.5,5,5,5,15,🏆 VIP
17647.0,305,2,198.60000000000002,1,3,1,5,⚠️ À réactiver
17648.0,21,1,418.87,4,2,2,8,🔄 Moyen
17649.0,105,3,680.6999999999999,2,3,3,8,🔄 Moyen
17651.0,123,8,1745.92,2,5,4,11,⭐ Fidèle
17655.0,2,3,1013.54,5,3,4,12,⭐ Fidèle
17657.0,66,1,126.0,3,2,1,6,⚠️ À réactiver
17659.0,8,4,829.38,5,4,3,12,⭐ Fidèle
17660.0,373,1,163.47,1,2,1,4,⚠️ À réactiver
17661.0,277,1,-54.0,1,2,1,4,⚠️ À réactiver
17662.0,297,2,412.92,1,3,2,6,⚠️ À réactiver
17663.0,53,14,3292.77,3,5,5,13,🏆 VIP
17664.0,110,2,561.59,2,3,3,8,🔄 Moyen
17665.0,129,1,563.1,2,2,3,7,🔄 Moyen
17666.0,113,3,1319.6399999999999,2,3,4,9,🔄 Moyen
17667.0,53,7,1828.29,3,5,4,12,⭐ Fidèle
17669.0,98,3,2735.63,2,3,5,10,⭐ Fidèle
17671.0,1,2,830.63,5,3,3,11,⭐ Fidèle
17672.0,53,5,2600.46,3,4,5,12,⭐ Fidèle
17673.0,11,8,2594.11,5,5,5,15,🏆 VIP
17674.0,4,1,300.66,5,2,2,9,🔄 Moyen
17675.0,3,51,17507.74,5,5,5,15,🏆 VIP
17676.0,2,7,1339.25,5,5,4,14,🏆 VIP
17677.0,2,52,19647.41,5,5,5,15,🏆 VIP
17678.0,203,2,281.7,1,3,2,6,⚠️ À réactiver
17679.0,157,9,1174.45,2,5,4,11,⭐ Fidèle
17680.0,19,3,278.1,4,3,2,9,🔄 Moyen
17681.0,233,6,529.6,1,4,3,8,🔄 Moyen
17682.0,4,6,1982.45,5,4,4,13,🏆 VIP
17683.0,21,3,819.01,4,3,3,10,⭐ Fidèle
17685.0,8,8,2736.64,5,5,5,15,🏆 VIP
17686.0,59,2,2557.35,3,3,5,11,⭐ Fidèle
17687.0,56,1,432.68,3,2,2,7,🔄 Moyen
17688.0,10,2,286.5,5,3,2,10,⭐ Fidèle
17689.0,24,2,317.08,4,3,2,9,🔄 Moyen
17690.0,2,8,2690.15,5,5,5,15,🏆 VIP
17691.0,4,4,479.45,5,4,3,12,⭐ Fidèle
17692.0,32,9,2228.96,4,5,5,14,🏆 VIP
17694.0,147,2,1412.85,2,3,4,9,🔄 Moyen
17695.0,24,4,955.1999999999999,4,4,4,12,⭐ Fidèle
17696.0,16,34,5179.84,4,5,5,14,🏆 VIP
17699.0,112,2,442.0,2,3,2,7,🔄 Moyen
17700.0,1,12,4121.98,5,5,5,15,🏆 VIP
17702.0,1,4,1192.07,5,4,4,13,🏆 VIP
17703.0,54,1,296.09999999999997,3,2,2,7,🔄 Moyen
17705.0,91,2,260.38,2,3,2,7,🔄 Moyen
17706.0,2,24,9446.53,5,5,5,15,🏆 VIP
17707.0,12,7,452.65,5,5,2,12,⭐ Fidèle
17708.0,38,2,620.85,3,3,3,9,🔄 Moyen
17709.0,106,4,533.56,2,4,3,9,🔄 Moyen
17710.0,59,1,293.5,3,2,2,7,🔄 Moyen
17713.0,18,4,1198.09,4,4,4,12,⭐ Fidèle
17714.0,21,8,1223.58,4,5,4,13,🏆 VIP
17715.0,228,1,163.2,1,2,1,4,⚠️ À réactiver
17716.0,32,15,10165.53,4,5,5,14,🏆 VIP
17717.0,57,1,376.92,3,2,2,7,🔄 Moyen
17718.0,262,2,247.63,1,3,2,6,⚠️ À réactiver
17720.0,3,9,1519.12,5,5,4,14,🏆 VIP
17721.0,295,1,307.21000000000004,1,2,2,5,⚠️ À réactiver
17722.0,2,2,2006.32,5,3,4,12,⭐ Fidèle
17723.0,11,1,102.0,5,2,1,8,🔄 Moyen
17726.0,31,8,1089.56,4,5,4,13,🏆 VIP
17728.0,40,3,1345.45,3,3,4,10,⭐ Fidèle
17729.0,232,1,438.65,1,2,2,5,⚠️ À réactiver
17730.0,18,8,2468.52,4,5,5,14,🏆 VIP
17731.0,257,2,468.88,1,3,2,6,⚠️ À réactiver
17732.0,8,10,2144.17,5,5,5,15,🏆 VIP
17734.0,161,3,741.6899999999999,2,3,3,8,🔄 Moyen
17735.0,3,11,4052.56,5,5,5,15,🏆 VIP
17738.0,31,10,2282.0099999999998,4,5,5,14,🏆 VIP
17739.0,10,12,4932.09,5,5,5,15,🏆 VIP
17740.0,25,6,426.9,4,4,2,10,⭐ Fidèle
17741.0,42,2,101.1,3,3,1,7,🔄 Moyen
17742.0,64,9,1743.37,3,5,4,12,⭐ Fidèle
17743.0,78,2,208.85,2,3,1,6,⚠️ À réactiver
17744.0,16,1,326.74,4,2,2,8,🔄 Moyen
17745.0,113,2,600.34,2,3,3,8,🔄 Moyen
17746.0,107,5,774.63,2,4,3,9,🔄 Moyen
17748.0,163,1,358.15,2,2,2,6,⚠️ À réactiver
17749.0,182,1,351.66,1,2,2,5,⚠️ À réactiver
17751.0,57,1,157.85999999999999,3,2,1,6,⚠️ À réactiver
17753.0,100,5,388.06,2,4,2,8,🔄 Moyen
17754.0,10,10,2769.47,5,5,5,15,🏆 VIP
17755.0,60,1,-72.23,3,2,1,6,⚠️ À réactiver
17756.0,11,3,733.7,5,3,3,11,⭐ Fidèle
17757.0,4,31,3757.35,5,5,5,15,🏆 VIP
17758.0,63,4,1555.83,3,4,4,11,⭐ Fidèle
17759.0,29,2,441.92,4,3,2,9,🔄 Moyen
17760.0,9,6,624.09,5,4,3,12,⭐ Fidèle
17762.0,92,1,129.75,2,2,1,5,⚠️ À réactiver
17763.0,281,4,36.15,1,4,1,6,⚠️ À réactiver
17764.0,38,3,804.82,3,3,3,9,🔄 Moyen
17765.0,84,1,158.92,2,2,1,5,⚠️ À réactiver
17766.0,17,2,299.61,4,3,2,9,🔄 Moyen
17767.0,46,1,141.85,3,2,1,6,⚠️ À réactiver
17768.0,23,5,1231.38,4,4,4,12,⭐ Fidèle
17769.0,19,9,3034.03,4,5,5,14,🏆 VIP
17771.0,72,2,141.6,2,3,1,6,⚠️ À réactiver
17772.0,28,1,202.0,4,2,1,7,🔄 Moyen
17773.0,150,2,585.27,2,3,3,8,🔄 Moyen
17774.0,33,8,1730.24,4,5,4,13,🏆 VIP
17776.0,22,3,331.81,4,3,2,9,🔄 Moyen
17778.0,297,1,197.7,1,2,1,4,⚠️ À réactiver
17780.0,303,3,352.91,1,3,2,6,⚠️ À réactiver
17782.0,18,2,679.02,4,3,3,10,⭐ Fidèle
17783.0,148,1,96.44,2,2,1,5,⚠️ À réactiver
17784.0,186,1,112.86,1,2,1,4,⚠️ À réactiver
17785.0,81,2,271.44,2,3,2,7,🔄 Moyen
17787.0,7,1,736.28,5,2,3,10,⭐ Fidèle
17789.0,297,1,171.25,1,2,1,4,⚠️ À réactiver
17790.0,14,6,818.06,5,4,3,12,⭐ Fidèle
17792.0,103,2,370.05,2,3,2,7,🔄 Moyen
17794.0,322,2,147.3,1,3,1,5,⚠️ À réactiver
17796.0,5,4,664.09,5,4,3,12,⭐ Fidèle
17797.0,31,5,1205.44,4,4,4,12,⭐ Fidèle
17798.0,217,1,183.09,1,2,1,4,⚠️ À réactiver
17799.0,25,12,3190.66,4,5,5,14,🏆 VIP
17801.0,87,4,795.78,2,4,3,9,🔄 Moyen
17802.0,8,13,3664.0,5,5,5,15,🏆 VIP
17803.0,28,1,184.66,4,2,1,7,🔄 Moyen
17804.0,12,4,380.13,5,4,2,11,⭐ Fidèle
17805.0,246,1,414.72,1,2,2,5,⚠️ À réactiver
17807.0,31,3,437.87,4,3,2,9,🔄 Moyen
17808.0,184,4,262.64,1,4,2,7,🔄 Moyen
17809.0,7,12,5871.2300000000005,5,5,5,15,🏆 VIP
17810.0,304,3,344.86,1,3,2,6,⚠️ À réactiver
17811.0,10,9,1770.82,5,5,4,14,🏆 VIP
17812.0,4,4,433.73,5,4,2,11,⭐ Fidèle
17814.0,11,2,1617.32,5,3,4,12,⭐ Fidèle
17815.0,29,1,591.96,4,2,3,9,🔄 Moyen
17816.0,1,3,75.75999999999999,5,3,1,9,🔄 Moyen
17817.0,14,4,413.47,5,4,2,11,⭐ Fidèle
17818.0,373,1,130.18,1,2,1,4,⚠️ À réactiver
17819.0,7,6,2907.65,5,4,5,14,🏆 VIP
17820.0,10,1,183.56,5,2,1,8,🔄 Moyen
17821.0,42,1,334.62,3,2,2,7,🔄 Moyen
17822.0,56,5,2188.5,3,4,5,12,⭐ Fidèle
17823.0,57,2,494.25,3,3,3,9,🔄 Moyen
17825.0,234,4,731.96,1,4,3,8,🔄 Moyen
17826.0,10,1,134.59,5,2,1,8,🔄 Moyen
17827.0,220,2,385.84,1,3,2,6,⚠️ À réactiver
17829.0,45,5,3791.18,3,4,5,12,⭐ Fidèle
17833.0,359,1,342.36,1,2,2,5,⚠️ À réactiver
17834.0,50,2,730.47,3,3,3,9,🔄 Moyen
17838.0,1,11,3926.85,5,5,5,15,🏆 VIP
17840.0,79,1,185.72,2,2,1,5,⚠️ À réactiver
17841.0,1,126,29175.41,5,5,5,15,🏆 VIP
17842.0,238,1,430.69,1,2,2,5,⚠️ À réactiver
17843.0,47,1,120.75,3,2,1,6,⚠️ À réactiver
17845.0,191,4,598.1899999999999,1,4,3,8,🔄 Moyen
17847.0,151,2,129.69,2,3,1,6,⚠️ À réactiver
17848.0,53,22,2736.95,3,5,5,13,🏆 VIP
17849.0,116,4,457.96000000000004,2,4,2,8,🔄 Moyen
17850.0,8,158,50414.5,5,5,5,15,🏆 VIP
17851.0,58,6,1563.34,3,4,4,11,⭐ Fidèle
17852.0,24,3,548.87,4,3,3,10,⭐ Fidèle
17853.0,43,3,1608.19,3,3,4,10,⭐ Fidèle
17854.0,98,4,760.19,2,4,3,9,🔄 Moyen
17855.0,8,1,208.97,5,2,1,8,🔄 Moyen
17857.0,1,2,1803.2,5,3,4,12,⭐ Fidèle
17858.0,5,21,7567.64,5,5,5,15,🏆 VIP
17860.0,4,4,762.74,5,4,3,12,⭐ Fidèle
17861.0,21,13,3005.39,4,5,5,14,🏆 VIP
17862.0,21,3,948.1899999999999,4,3,4,11,⭐ Fidèle
17863.0,5,7,2585.2,5,5,5,15,🏆 VIP
17864.0,21,2,326.82,4,3,2,9,🔄 Moyen
17865.0,11,35,15490.51,5,5,5,15,🏆 VIP
17866.0,120,2,805.3,2,3,3,8,🔄 Moyen
17867.0,46,12,273.03,3,5,2,10,⭐ Fidèle
17868.0,22,1,234.65,4,2,2,8,🔄 Moyen
17869.0,4,3,607.98,5,3,3,11,⭐ Fidèle
17870.0,2,2,1213.8000000000002,5,3,4,12,⭐ Fidèle
17871.0,33,4,963.09,4,4,4,12,⭐ Fidèle
17872.0,17,1,235.87,4,2,2,8,🔄 Moyen
17873.0,9,15,4465.2,5,5,5,15,🏆 VIP
17875.0,324,1,167.1,1,2,1,4,⚠️ À réactiver
17876.0,35,3,3424.02,4,3,5,12,⭐ Fidèle
17878.0,31,2,1032.88,4,3,4,11,⭐ Fidèle
17880.0,275,2,366.0,1,3,2,6,⚠️ À réactiver
17882.0,15,2,313.46,5,3,2,10,⭐ Fidèle
17883.0,175,4,308.18,2,4,2,8,🔄 Moyen
17884.0,4,21,2311.44,5,5,5,15,🏆 VIP
17886.0,73,4,698.82,2,4,3,9,🔄 Moyen
17888.0,10,21,793.12,5,5,3,13,🏆 VIP
17889.0,10,5,571.0,5,4,3,12,⭐ Fidèle
17894.0,2,13,1277.85,5,5,4,14,🏆 VIP
17897.0,3,9,1992.9,5,5,4,14,🏆 VIP
17898.0,88,2,147.12,2,3,1,6,⚠️ À réactiver
17901.0,157,2,149.7,2,3,1,6,⚠️ À réactiver
17902.0,182,1,216.4,1,2,1,4,⚠️ À réactiver
17903.0,30,1,381.09000000000003,4,2,2,8,🔄 Moyen
17905.0,9,11,1573.98,5,5,4,14,🏆 VIP
17907.0,276,1,291.76,1,2,2,5,⚠️ À réactiver
17908.0,9,7,1114.61,5,5,4,14,🏆 VIP
17909.0,373,1,132.55,1,2,1,4,⚠️ À réactiver
17910.0,362,1,261.7,1,2,2,5,⚠️ À réactiver
17912.0,11,1,64.49,5,2,1,8,🔄 Moyen
17913.0,36,12,3068.04,3,5,5,13,🏆 VIP
17915.0,187,1,242.13,1,2,2,5,⚠️ À réactiver
17916.0,264,2,43.87,1,3,1,5,⚠️ À réactiver
17918.0,136,3,396.39,2,3,2,7,🔄 Moyen
17919.0,74,1,536.28,2,2,3,7,🔄 Moyen
17920.0,4,41,20305.81,5,5,5,15,🏆 VIP
17921.0,14,8,1556.83,5,5,4,14,🏆 VIP
17922.0,179,1,170.4,1,2,1,4,⚠️ À réactiver
17923.0,163,2,289.5,2,3,2,7,🔄 Moyen
17924.0,8,3,550.95,5,3,3,11,⭐ Fidèle
17925.0,8,1,244.08,5,2,2,9,🔄 Moyen
17926.0,80,3,638.2,2,3,3,8,🔄 Moyen
17927.0,357,1,294.0,1,2,2,5,⚠️ À réactiver
17928.0,207,1,128.7,1,2,1,4,⚠️ À réactiver
17929.0,23,8,2239.1,4,5,5,14,🏆 VIP
17930.0,15,10,2502.44,5,5,5,15,🏆 VIP
17931.0,33,16,2897.6,4,5,5,14,🏆 VIP
17933.0,268,1,114.69,1,2,1,4,⚠️ À réactiver
17934.0,42,1,344.9,3,2,2,7,🔄 Moyen
17935.0,36,6,509.75,3,4,3,10,⭐ Fidèle
17938.0,56,1,144.29,3,2,1,6,⚠️ À réactiver
17940.0,81,8,24976.44,2,5,5,12,⭐ Fidèle
17941.0,226,3,1128.72,1,3,4,8,🔄 Moyen
17943.0,315,1,-165.03,1,2,1,4,⚠️ À réactiver
17944.0,59,1,75.41,3,2,1,6,⚠️ À réactiver
17945.0,332,3,360.34999999999997,1,3,2,6,⚠️ À réactiver
17949.0,7,87,46144.75,5,5,5,15,🏆 VIP
17950.0,1,7,940.53,5,5,4,14,🏆 VIP
17951.0,9,2,627.54,5,3,3,11,⭐ Fidèle
17952.0,14,4,819.61,5,4,3,12,⭐ Fidèle
17953.0,176,1,160.82,2,2,1,5,⚠️ À réactiver
17954.0,3,14,1536.19,5,5,4,14,🏆 VIP
17955.0,291,2,392.6,1,3,2,6,⚠️ À réactiver
17958.0,364,1,465.41999999999996,1,2,2,5,⚠️ À réactiver
17959.0,228,1,140.75,1,2,1,4,⚠️ À réactiver
17960.0,158,2,61.300000000000004,2,3,1,6,⚠️ À réactiver
17961.0,8,64,1682.65,5,5,4,14,🏆 VIP
17962.0,185,4,570.1899999999999,1,4,3,8,🔄 Moyen
17963.0,107,4,651.51,2,4,3,9,🔄 Moyen
17964.0,8,1,261.76,5,2,2,9,🔄 Moyen
17965.0,1,21,4495.21,5,5,5,15,🏆 VIP
17966.0,227,5,875.99,1,4,3,8,🔄 Moyen
17967.0,7,2,234.22,5,3,2,10,⭐ Fidèle
17968.0,9,4,610.69,5,4,3,12,⭐ Fidèle
17969.0,138,25,2022.99,2,5,4,11,⭐ Fidèle
17971.0,184,1,161.94,1,2,1,4,⚠️ À réactiver
17974.0,17,3,1117.27,4,3,4,11,⭐ Fidèle
17975.0,2,13,2534.07,5,5,5,15,🏆 VIP
17976.0,8,1,353.19,5,2,2,9,🔄 Moyen
17977.0,22,2,1219.59,4,3,4,11,⭐ Fidèle
17978.0,1,4,1160.84,5,4,4,13,🏆 VIP
17980.0,29,1,221.97,4,2,1,7,🔄 Moyen
17981.0,46,1,239.12,3,2,2,7,🔄 Moyen
17982.0,316,1,138.18,1,2,1,4,⚠️ À réactiver
17983.0,31,1,171.71,4,2,1,7,🔄 Moyen
17984.0,28,4,1038.59,4,4,4,12,⭐ Fidèle
17987.0,12,5,729.55,5,4,3,12,⭐ Fidèle
17988.0,123,7,288.42,2,5,2,9,🔄 Moyen
17989.0,15,1,228.83,5,2,1,8,🔄 Moyen
17990.0,16,4,891.73,4,4,3,11,⭐ Fidèle
17991.0,227,1,227.2,1,2,1,4,⚠️ À réactiver
17992.0,25,1,254.13,4,2,2,8,🔄 Moyen
17993.0,253,1,235.19,1,2,2,5,⚠️ À réactiver
17994.0,24,8,1633.18,4,5,4,13,🏆 VIP
17995.0,18,2,419.38,4,3,2,9,🔄 Moyen
17996.0,15,3,482.33,5,3,3,11,⭐ Fidèle
17998.0,16,4,601.74,4,4,3,11,⭐ Fidèle
17999.0,2,2,348.84000000000003,5,3,2,10,⭐ Fidèle
18000.0,200,1,124.25,1,2,1,4,⚠️ À réactiver
18001.0,85,4,536.61,2,4,3,9,🔄 Moyen
18002.0,11,4,249.92,5,4,2,11,⭐ Fidèle
18003.0,12,1,358.61,5,2,2,9,🔄 Moyen
18006.0,17,3,553.1800000000001,4,3,3,10,⭐ Fidèle
18007.0,28,1,220.32,4,2,1,7,🔄 Moyen
18008.0,51,14,17670.94,3,5,5,13,🏆 VIP
18009.0,73,12,1824.84,2,5,4,11,⭐ Fidèle
18011.0,9,2,424.24,5,3,2,10,⭐ Fidèle
18012.0,359,1,115.3,1,2,1,4,⚠️ À réactiver
18016.0,46,2,476.9,3,3,3,9,🔄 Moyen
18017.0,67,1,165.0,3,2,1,6,⚠️ À réactiver
18018.0,35,3,34.55,4,3,1,8,🔄 Moyen
18020.0,179,2,129.28,1,3,1,5,⚠️ À réactiver
18021.0,145,2,227.06,2,3,1,6,⚠️ À réactiver
18022.0,21,4,983.6800000000001,4,4,4,12,⭐ Fidèle
18023.0,176,1,-3248.86,2,2,1,5,⚠️ À réactiver
18025.0,15,6,1177.72,5,4,4,13,🏆 VIP
18026.0,136,2,2074.07,2,3,5,10,⭐ Fidèle
18028.0,219,1,192.04999999999998,1,2,1,4,⚠️ À réactiver
18029.0,278,1,433.77,1,2,2,5,⚠️ À réactiver
18031.0,14,1,462.09999999999997,5,2,2,9,🔄 Moyen
18034.0,11,1,370.82,5,2,2,9,🔄 Moyen
18035.0,21,2,546.34,4,3,3,10,⭐ Fidèle
18036.0,21,8,1158.02,4,5,4,13,🏆 VIP
18037.0,57,9,97.39999999999999,3,5,1,9,🔄 Moyen
18038.0,192,1,149.41,1,2,1,4,⚠️ À réactiver
18039.0,10,4,579.17,5,4,3,12,⭐ Fidèle
18041.0,1,21,4508.51,5,5,5,15,🏆 VIP
18042.0,177,1,116.10000000000001,2,2,1,5,⚠️ À réactiver
18043.0,2,1,316.46,5,2,2,9,🔄 Moyen
18044.0,23,8,1417.01,4,5,4,13,🏆 VIP
18046.0,285,1,189.63,1,2,1,4,⚠️ À réactiver
18047.0,17,2,342.69,4,3,2,9,🔄 Moyen
18048.0,129,1,229.44,2,2,1,5,⚠️ À réactiver
18049.0,73,2,556.52,2,3,3,8,🔄 Moyen
18050.0,29,1,337.66,4,2,2,8,🔄 Moyen
18051.0,270,8,2275.98,1,5,5,11,⭐ Fidèle
18052.0,200,1,10877.18,1,2,5,8,🔄 Moyen
18053.0,120,4,230.7,2,4,2,8,🔄 Moyen
18054.0,28,1,176.5,4,2,1,7,🔄 Moyen
18055.0,3,6,4411.38,5,4,5,14,🏆 VIP
18056.0,232,2,176.1,1,3,1,5,⚠️ À réactiver
18057.0,29,3,1203.56,4,3,4,11,⭐ Fidèle
18058.0,177,2,603.9,2,3,3,8,🔄 Moyen
18060.0,44,2,1185.46,3,3,4,10,⭐ Fidèle
18061.0,2,20,4361.06,5,5,5,15,🏆 VIP
18062.0,16,6,802.85,4,4,3,11,⭐ Fidèle
18063.0,26,2,186.6,4,3,1,8,🔄 Moyen
18064.0,82,13,3627.18,2,5,5,12,⭐ Fidèle
18065.0,24,17,3456.8,4,5,5,14,🏆 VIP
18066.0,22,2,1122.4,4,3,4,11,⭐ Fidèle
18069.0,19,6,2503.89,4,4,5,13,🏆 VIP
18070.0,305,2,307.75,1,3,2,6,⚠️ À réactiver
18071.0,1,5,975.63,5,4,4,13,🏆 VIP
18074.0,9,2,1019.44,5,3,4,12,⭐ Fidèle
18075.0,10,17,3041.19,5,5,5,15,🏆 VIP
18076.0,16,1,151.49,4,2,1,7,🔄 Moyen
18077.0,2,8,1705.55,5,5,4,14,🏆 VIP
18078.0,61,2,508.46999999999997,3,3,3,9,🔄 Moyen
18079.0,127,1,590.78,2,2,3,7,🔄 Moyen
18083.0,33,1,470.73,4,2,2,8,🔄 Moyen
18084.0,10,3,106.19999999999999,5,3,1,9,🔄 Moyen
18085.0,9,3,955.8,5,3,4,12,⭐ Fidèle
18087.0,15,17,10641.5,5,5,5,15,🏆 VIP
18089.0,82,1,428.45,2,2,2,6,⚠️ À réactiver
18090.0,57,1,349.4,3,2,2,7,🔄 Moyen
18091.0,229,1,360.85,1,2,2,5,⚠️ À réactiver
18092.0,1,9,7107.43,5,5,5,15,🏆 VIP
18093.0,80,4,2346.19,2,4,5,11,⭐ Fidèle
18094.0,82,8,3305.32,2,5,5,12,⭐ Fidèle
18095.0,63,3,1723.04,3,3,4,10,⭐ Fidèle
18096.0,78,3,894.13,2,3,3,8,🔄 Moyen
18097.0,15,7,1959.32,5,5,4,14,🏆 VIP
18098.0,32,1,550.84,4,2,3,9,🔄 Moyen
18100.0,186,1,451.56,1,2,2,5,⚠️ À réactiver
18101.0,10,3,405.51,5,3,2,10,⭐ Fidèle
18102.0,1,95,341776.73,5,5,5,15,🏆 VIP
18103.0,185,1,105.8,1,2,1,4,⚠️ À réactiver
18106.0,112,5,1030.76,2,4,4,10,⭐ Fidèle
18107.0,78,1,167.13,2,2,1,5,⚠️ À réactiver
18108.0,232,2,577.81,1,3,3,7,🔄 Moyen
18109.0,5,15,1829.34,5,5,4,14,🏆 VIP
18110.0,47,1,199.13,3,2,1,6,⚠️ À réactiver
18111.0,219,2,398.9,1,3,2,6,⚠️ À réactiver
18112.0,54,2,423.27,3,3,2,8,🔄 Moyen
18113.0,4,1,76.32,5,2,1,8,🔄 Moyen
18115.0,333,1,9.700000000000001,1,2,1,4,⚠️ À réactiver
18116.0,12,5,736.27,5,4,3,12,⭐ Fidèle
18118.0,5,5,1074.3,5,4,4,13,🏆 VIP
18119.0,3,1,181.12,5,2,1,8,🔄 Moyen
18123.0,149,1,95.15,2,2,1,5,⚠️ À réactiver
18124.0,108,1,111.53,2,2,1,5,⚠️ À réactiver
18127.0,39,1,212.8,3,2,1,6,⚠️ À réactiver
18128.0,173,1,420.04,2,2,2,6,⚠️ À réactiver
18131.0,267,1,222.96,1,2,1,4,⚠️ À réactiver
18132.0,140,1,226.9,2,2,1,5,⚠️ À réactiver
18134.0,234,2,445.0,1,3,2,6,⚠️ À réactiver
18135.0,28,8,547.31,4,5,3,12,⭐ Fidèle
18136.0,38,5,769.88,3,4,3,10,⭐ Fidèle
18137.0,187,2,145.99,1,3,1,5,⚠️ À réactiver
18140.0,109,1,536.41,2,2,3,7,🔄 Moyen
18141.0,29,3,873.97,4,3,3,10,⭐ Fidèle
18144.0,9,8,2169.25,5,5,5,15,🏆 VIP
18145.0,18,8,2738.54,4,5,5,14,🏆 VIP
18148.0,282,1,114.1,1,2,1,4,⚠️ À réactiver
18149.0,40,4,1012.63,3,4,4,11,⭐ Fidèle
18151.0,56,5,1200.59,3,4,4,11,⭐ Fidèle
18152.0,282,1,426.69,1,2,2,5,⚠️ À réactiver
18153.0,295,1,246.22,1,2,2,5,⚠️ À réactiver
18154.0,24,3,533.41,4,3,3,10,⭐ Fidèle
18156.0,5,1,206.23000000000002,5,2,1,8,🔄 Moyen
18157.0,207,1,215.35,1,2,1,4,⚠️ À réactiver
18160.0,22,1,365.82,4,2,2,8,🔄 Moyen
18161.0,15,1,184.41,5,2,1,8,🔄 Moyen
18162.0,368,1,379.15999999999997,1,2,2,5,⚠️ À réactiver
18163.0,196,2,639.34,1,3,3,7,🔄 Moyen
18166.0,259,1,175.5,1,2,1,4,⚠️ À réactiver
18168.0,8,15,2536.48,5,5,5,15,🏆 VIP
18170.0,10,6,1897.69,5,4,4,13,🏆 VIP
18171.0,106,4,1206.0,2,4,4,10,⭐ Fidèle
18172.0,16,38,9811.66,4,5,5,14,🏆 VIP
18173.0,248,1,589.52,1,2,3,6,⚠️ À réactiver
18174.0,239,1,58.5,1,2,1,4,⚠️ À réactiver
18175.0,311,1,176.1,1,2,1,4,⚠️ À réactiver
18177.0,196,3,875.4499999999999,1,3,3,7,🔄 Moyen
18178.0,38,9,4481.08,3,5,5,13,🏆 VIP
18179.0,158,2,754.38,2,3,3,8,🔄 Moyen
18181.0,36,6,801.41,3,4,3,10,⭐ Fidèle
18182.0,99,1,291.13,2,2,2,6,⚠️ À réactiver
18186.0,358,1,329.58000000000004,1,2,2,5,⚠️ À réactiver
18187.0,259,3,682.19,1,3,3,7,🔄 Moyen
18188.0,66,4,1264.7,3,4,4,11,⭐ Fidèle
18189.0,255,2,312.24,1,3,2,6,⚠️ À réactiver
18190.0,239,3,461.15999999999997,1,3,2,6,⚠️ À réactiver
18191.0,113,1,321.6,2,2,2,6,⚠️ À réactiver
18193.0,2,3,942.74,5,3,4,12,⭐ Fidèle
18194.0,74,5,3188.2,2,4,5,11,⭐ Fidèle
18195.0,23,1,101.16,4,2,1,7,🔄 Moyen
18196.0,107,2,775.18,2,3,3,8,🔄 Moyen
18197.0,149,2,221.4,2,3,1,6,⚠️ À réactiver
18199.0,311,2,342.2,1,3,2,6,⚠️ À réactiver
18201.0,358,1,447.53,1,2,2,5,⚠️ À réactiver
18203.0,17,3,344.0,4,3,2,9,🔄 Moyen
18206.0,189,1,314.65999999999997,1,2,2,5,⚠️ À réactiver
18207.0,129,3,505.12,2,3,3,8,🔄 Moyen
18208.0,201,1,360.08,1,2,2,5,⚠️ À réactiver
18210.0,18,1,147.45,4,2,1,7,🔄 Moyen
18212.0,313,1,298.3,1,2,2,5,⚠️ À réactiver
18214.0,166,5,1480.99,2,4,4,10,⭐ Fidèle
18215.0,36,5,1939.6499999999999,3,4,4,11,⭐ Fidèle
18217.0,149,4,281.04999999999995,2,4,2,8,🔄 Moyen
18218.0,232,2,479.91999999999996,1,3,3,7,🔄 Moyen
18219.0,4,9,1487.62,5,5,4,14,🏆 VIP
18220.0,30,9,1473.9199999999998,4,5,4,13,🏆 VIP
18221.0,21,2,337.03,4,3,2,9,🔄 Moyen
18223.0,21,25,7182.35,4,5,5,14,🏆 VIP
18225.0,1,19,7289.89,5,5,5,15,🏆 VIP
18226.0,14,24,6556.48,5,5,5,15,🏆 VIP
18227.0,113,2,0.0,2,3,1,6,⚠️ À réactiver
18229.0,2,10,3526.81,5,5,5,15,🏆 VIP
18230.0,1,3,1474.11,5,3,4,12,⭐ Fidèle
18231.0,42,24,4782.0,3,5,5,13,🏆 VIP
18234.0,187,1,179.6,1,2,1,4,⚠️ À réactiver
18236.0,24,6,913.11,4,4,3,11,⭐ Fidèle
18238.0,151,1,270.92,2,2,2,6,⚠️ À réactiver
18239.0,8,2,588.75,5,3,3,11,⭐ Fidèle
18241.0,51,5,896.0,3,4,3,10,⭐ Fidèle
18242.0,81,4,1372.72,2,4,4,10,⭐ Fidèle
18243.0,50,1,515.78,3,2,3,8,🔄 Moyen
18244.0,66,2,568.64,3,3,3,9,🔄 Moyen
18245.0,10,15,3728.67,5,5,5,15,🏆 VIP
18246.0,245,1,162.72,1,2,1,4,⚠️ À réactiver
18247.0,45,6,721.43,3,4,3,10,⭐ Fidèle
18251.0,81,8,21964.14,2,5,5,12,⭐ Fidèle
18252.0,184,6,938.92,1,4,3,8,🔄 Moyen
18253.0,278,1,317.88,1,2,2,5,⚠️ À réactiver
18254.0,217,1,267.9,1,2,2,5,⚠️ À réactiver
18255.0,92,1,199.85,2,2,1,5,⚠️ À réactiver
18256.0,23,1,110.69999999999999,4,2,1,7,🔄 Moyen
18257.0,82,6,2231.42,2,4,5,11,⭐ Fidèle
18258.0,100,8,2040.97,2,5,4,11,⭐ Fidèle
18259.0,2,5,1979.6,5,4,4,13,🏆 VIP
18260.0,10,24,7156.95,5,5,5,15,🏆 VIP
18262.0,29,2,428.06,4,3,2,9,🔄 Moyen
18264.0,134,1,603.25,2,2,3,7,🔄 Moyen
18266.0,70,1,251.1,3,2,2,7,🔄 Moyen
18267.0,295,2,252.87,1,3,2,6,⚠️ À réactiver
18268.0,227,6,1451.22,1,4,4,9,🔄 Moyen
18269.0,2,1,168.6,5,2,1,8,🔄 Moyen
18270.0,68,1,161.4,3,2,1,6,⚠️ À réactiver
18271.0,245,2,680.85,1,3,3,7,🔄 Moyen
18272.0,65,4,1282.55,3,4,4,11,⭐ Fidèle
18273.0,226,1,153.0,1,2,1,4,⚠️ À réactiver
18275.0,214,2,741.85,1,3,3,7,🔄 Moyen
18276.0,21,7,1297.31,4,5,4,13,🏆 VIP
18277.0,24,6,1013.75,4,4,4,12,⭐ Fidèle
18278.0,40,1,240.3,3,2,2,7,🔄 Moyen
18279.0,155,1,231.34,2,2,2,6,⚠️ À réactiver
18280.0,16,2,291.85,4,3,2,9,🔄 Moyen
18281.0,213,1,120.32,1,2,1,4,⚠️ À réactiver
18283.0,18,6,641.77,4,4,3,11,⭐ Fidèle
18284.0,65,2,436.68,3,3,2,8,🔄 Moyen
18285.0,296,1,427.0,1,2,2,5,⚠️ À réactiver
18286.0,112,3,1188.43,2,3,4,9,🔄 Moyen
18287.0,18,5,2340.61,4,4,5,13,🏆 VIP
